counter_id,date,time,channel_1,channel_2,
42,22/03/2015,0,6,3,9
42,22/03/2015,1,4,2,6
42,22/03/2015,2,2,1,3
42,22/03/2015,3,2,0,2
42,22/03/2015,4,0,3,3
42,22/03/2015,5,0,0,0
42,22/03/2015,6,1,1,2
42,22/03/2015,7,5,14,19
42,22/03/2015,8,5,15,20
42,22/03/2015,9,12,19,31
42,22/03/2015,10,19,22,41
42,22/03/2015,11,22,37,59
42,22/03/2015,12,22,29,51
42,22/03/2015,13,18,19,37
42,22/03/2015,14,21,34,55
42,22/03/2015,15,22,27,49
42,22/03/2015,16,43,24,67
42,22/03/2015,17,28,26,54
42,22/03/2015,18,21,23,44
42,22/03/2015,19,24,11,35
42,22/03/2015,20,28,8,36
42,22/03/2015,21,10,7,17
42,22/03/2015,22,6,10,16
42,22/03/2015,23,4,4,8
42,23/03/2015,0,5,2,7
42,23/03/2015,1,2,0,2
42,23/03/2015,2,2,1,3
42,23/03/2015,3,2,0,2
42,23/03/2015,4,0,0,0
42,23/03/2015,5,1,2,3
42,23/03/2015,6,6,8,14
42,23/03/2015,7,20,41,61
42,23/03/2015,8,42,116,158
42,23/03/2015,9,18,87,105
42,23/03/2015,10,16,36,52
42,23/03/2015,11,21,29,50
42,23/03/2015,12,25,27,52
42,23/03/2015,13,21,31,52
42,23/03/2015,14,24,30,54
42,23/03/2015,15,30,23,53
42,23/03/2015,16,56,29,85
42,23/03/2015,17,101,63,164
42,23/03/2015,18,51,50,101
42,23/03/2015,19,42,16,58
42,23/03/2015,20,37,12,49
42,23/03/2015,21,20,9,29
42,23/03/2015,22,19,6,25
42,23/03/2015,23,4,2,6
42,24/03/2015,0,4,3,7
42,24/03/2015,1,0,1,1
42,24/03/2015,2,0,1,1
42,24/03/2015,3,1,0,1
42,24/03/2015,4,1,0,1
42,24/03/2015,5,0,2,2
42,24/03/2015,6,2,7,9
42,24/03/2015,7,16,50,66
42,24/03/2015,8,33,119,152
42,24/03/2015,9,26,70,96
42,24/03/2015,10,18,40,58
42,24/03/2015,11,13,34,47
42,24/03/2015,12,22,30,52
42,24/03/2015,13,23,21,44
42,24/03/2015,14,14,29,43
42,24/03/2015,15,44,24,68
42,24/03/2015,16,46,31,77
42,24/03/2015,17,98,59,157
42,24/03/2015,18,63,50,113
42,24/03/2015,19,51,28,79
42,24/03/2015,20,39,20,59
42,24/03/2015,21,36,6,42
42,24/03/2015,22,23,6,29
42,24/03/2015,23,12,2,14
42,25/03/2015,0,3,1,4
42,25/03/2015,1,4,0,4
42,25/03/2015,2,1,0,1
42,25/03/2015,3,1,0,1
42,25/03/2015,4,1,0,1
42,25/03/2015,5,2,1,3
42,25/03/2015,6,3,8,11
42,25/03/2015,7,19,44,63
42,25/03/2015,8,36,110,146
42,25/03/2015,9,19,77,96
42,25/03/2015,10,17,34,51
42,25/03/2015,11,20,36,56
42,25/03/2015,12,22,27,49
42,25/03/2015,13,29,34,63
42,25/03/2015,14,30,31,61
42,25/03/2015,15,46,22,68
42,25/03/2015,16,48,51,99
42,25/03/2015,17,79,73,152
42,25/03/2015,18,78,46,124
42,25/03/2015,19,35,20,55
42,25/03/2015,20,33,13,46
42,25/03/2015,21,28,15,43
42,25/03/2015,22,24,6,30
42,25/03/2015,23,9,4,13
42,26/03/2015,0,2,3,5
42,26/03/2015,1,4,0,4
42,26/03/2015,2,2,0,2
42,26/03/2015,3,0,0,0
42,26/03/2015,4,0,1,1
42,26/03/2015,5,1,1,2
42,26/03/2015,6,1,6,7
42,26/03/2015,7,15,24,39
42,26/03/2015,8,25,98,123
42,26/03/2015,9,15,66,81
42,26/03/2015,10,10,32,42
42,26/03/2015,11,12,22,34
42,26/03/2015,12,22,23,45
42,26/03/2015,13,30,27,57
42,26/03/2015,14,18,24,42
42,26/03/2015,15,19,15,34
42,26/03/2015,16,52,38,90
42,26/03/2015,17,95,45,140
42,26/03/2015,18,48,46,94
42,26/03/2015,19,47,19,66
42,26/03/2015,20,32,14,46
42,26/03/2015,21,30,14,44
42,26/03/2015,22,9,6,15
42,26/03/2015,23,15,4,19
42,27/03/2015,0,4,5,9
42,27/03/2015,1,2,2,4
42,27/03/2015,2,6,1,7
42,27/03/2015,3,2,0,2
42,27/03/2015,4,0,0,0
42,27/03/2015,5,0,2,2
42,27/03/2015,6,3,7,10
42,27/03/2015,7,16,36,52
42,27/03/2015,8,31,84,115
42,27/03/2015,9,17,73,90
42,27/03/2015,10,17,37,54
42,27/03/2015,11,23,29,52
42,27/03/2015,12,24,37,61
42,27/03/2015,13,36,37,73
42,27/03/2015,14,24,31,55
42,27/03/2015,15,45,31,76
42,27/03/2015,16,42,39,81
42,27/03/2015,17,73,59,132
42,27/03/2015,18,48,25,73
42,27/03/2015,19,37,25,62
42,27/03/2015,20,23,15,38
42,27/03/2015,21,14,8,22
42,27/03/2015,22,9,3,12
42,27/03/2015,23,8,8,16
42,28/03/2015,0,3,0,3
42,28/03/2015,1,3,3,6
42,28/03/2015,2,4,0,4
42,28/03/2015,3,1,0,1
42,28/03/2015,4,1,1,2
42,28/03/2015,5,0,0,0
42,28/03/2015,6,0,3,3
42,28/03/2015,7,1,2,3
42,28/03/2015,8,3,6,9
42,28/03/2015,9,8,10,18
42,28/03/2015,10,3,16,19
42,28/03/2015,11,12,19,31
42,28/03/2015,12,16,17,33
42,28/03/2015,13,12,31,43
42,28/03/2015,14,12,9,21
42,28/03/2015,15,13,11,24
42,28/03/2015,16,22,6,28
42,28/03/2015,17,15,24,39
42,28/03/2015,18,11,14,25
42,28/03/2015,19,11,9,20
42,28/03/2015,20,11,7,18
42,28/03/2015,21,13,13,26
42,28/03/2015,22,8,3,11
42,28/03/2015,23,1,8,9
42,05/04/2015,0,7,3,10
42,05/04/2015,1,3,5,8
42,05/04/2015,2,2,0,2
42,05/04/2015,3,0,1,1
42,05/04/2015,4,0,1,1
42,05/04/2015,5,1,1,2
42,05/04/2015,6,0,5,5
42,05/04/2015,7,3,8,11
42,05/04/2015,8,6,2,8
42,05/04/2015,9,14,18,32
42,05/04/2015,10,13,23,36
42,05/04/2015,11,16,29,45
42,05/04/2015,12,14,24,38
42,05/04/2015,13,24,20,44
42,05/04/2015,14,27,24,51
42,05/04/2015,15,30,23,53
42,05/04/2015,16,26,31,57
42,05/04/2015,17,29,32,61
42,05/04/2015,18,18,19,37
42,05/04/2015,19,29,17,46
42,05/04/2015,20,14,6,20
42,05/04/2015,21,12,12,24
42,05/04/2015,22,9,5,14
42,05/04/2015,23,5,3,8
42,06/04/2015,0,4,2,6
42,06/04/2015,1,0,1,1
42,06/04/2015,2,1,0,1
42,06/04/2015,3,1,0,1
42,06/04/2015,4,0,1,1
42,06/04/2015,5,0,2,2
42,06/04/2015,6,3,4,7
42,06/04/2015,7,5,17,22
42,06/04/2015,8,9,34,43
42,06/04/2015,9,15,46,61
42,06/04/2015,10,13,30,43
42,06/04/2015,11,20,25,45
42,06/04/2015,12,37,27,64
42,06/04/2015,13,25,34,59
42,06/04/2015,14,27,44,71
42,06/04/2015,15,29,28,57
42,06/04/2015,16,43,40,83
42,06/04/2015,17,43,26,69
42,06/04/2015,18,49,20,69
42,06/04/2015,19,41,16,57
42,06/04/2015,20,24,11,35
42,06/04/2015,21,20,10,30
42,06/04/2015,22,8,3,11
42,06/04/2015,23,6,4,10
42,07/04/2015,0,6,4,10
42,07/04/2015,1,1,0,1
42,07/04/2015,2,0,0,0
42,07/04/2015,3,0,0,0
42,07/04/2015,4,0,0,0
42,07/04/2015,5,0,6,6
42,07/04/2015,6,2,6,8
42,07/04/2015,7,9,27,36
42,07/04/2015,8,20,80,100
42,07/04/2015,9,12,60,72
42,07/04/2015,10,20,35,55
42,07/04/2015,11,10,22,32
42,07/04/2015,12,19,28,47
42,07/04/2015,13,23,28,51
42,07/04/2015,14,31,20,51
42,07/04/2015,15,23,19,42
42,07/04/2015,16,43,24,67
42,07/04/2015,17,72,41,113
42,07/04/2015,18,40,44,84
42,07/04/2015,19,42,23,65
42,07/04/2015,20,26,11,37
42,07/04/2015,21,25,10,35
42,07/04/2015,22,10,4,14
42,07/04/2015,23,8,3,11
42,08/04/2015,0,0,2,2
42,08/04/2015,1,2,0,2
42,08/04/2015,2,2,0,2
42,08/04/2015,3,0,0,0
42,08/04/2015,4,0,0,0
42,08/04/2015,5,0,4,4
42,08/04/2015,6,7,12,19
42,08/04/2015,7,11,36,47
42,08/04/2015,8,31,85,116
42,08/04/2015,9,16,74,90
42,08/04/2015,10,12,42,54
42,08/04/2015,11,14,26,40
42,08/04/2015,12,27,31,58
42,08/04/2015,13,28,38,66
42,08/04/2015,14,41,26,67
42,08/04/2015,15,34,28,62
42,08/04/2015,16,47,43,90
42,08/04/2015,17,100,71,171
42,08/04/2015,18,39,44,83
42,08/04/2015,19,41,19,60
42,08/04/2015,20,28,13,41
42,08/04/2015,21,26,12,38
42,08/04/2015,22,17,6,23
42,08/04/2015,23,6,3,9
42,09/04/2015,0,5,2,7
42,09/04/2015,1,2,0,2
42,09/04/2015,2,0,1,1
42,09/04/2015,3,0,1,1
42,09/04/2015,4,0,0,0
42,09/04/2015,5,2,4,6
42,09/04/2015,6,6,11,17
42,09/04/2015,7,11,31,42
42,09/04/2015,8,28,76,104
42,09/04/2015,9,20,78,98
42,09/04/2015,10,13,38,51
42,09/04/2015,11,15,30,45
42,09/04/2015,12,24,23,47
42,09/04/2015,13,28,32,60
42,09/04/2015,14,37,29,66
42,09/04/2015,15,48,45,93
42,09/04/2015,16,51,43,94
42,09/04/2015,17,99,52,151
42,09/04/2015,18,60,45,105
42,09/04/2015,19,42,20,62
42,09/04/2015,20,42,16,58
42,09/04/2015,21,22,9,31
42,09/04/2015,22,7,6,13
42,09/04/2015,23,14,5,19
42,10/04/2015,0,3,0,3
42,10/04/2015,1,4,1,5
42,10/04/2015,2,1,1,2
42,10/04/2015,3,0,0,0
42,10/04/2015,4,0,1,1
42,10/04/2015,5,0,3,3
42,10/04/2015,6,6,12,18
42,10/04/2015,7,8,34,42
42,10/04/2015,8,28,60,88
42,10/04/2015,9,19,61,80
42,10/04/2015,10,18,33,51
42,10/04/2015,11,26,34,60
42,10/04/2015,12,30,32,62
42,10/04/2015,13,25,26,51
42,10/04/2015,14,23,26,49
42,10/04/2015,15,30,21,51
42,10/04/2015,16,59,27,86
42,10/04/2015,17,70,46,116
42,10/04/2015,18,38,47,85
42,10/04/2015,19,31,25,56
42,10/04/2015,20,26,13,39
42,10/04/2015,21,29,12,41
42,10/04/2015,22,10,5,15
42,10/04/2015,23,8,5,13
42,11/04/2015,0,4,7,11
42,11/04/2015,1,2,5,7
42,11/04/2015,2,1,0,1
42,11/04/2015,3,0,0,0
42,11/04/2015,4,0,1,1
42,11/04/2015,5,0,3,3
42,11/04/2015,6,0,2,2
42,11/04/2015,7,4,3,7
42,11/04/2015,8,4,9,13
42,11/04/2015,9,9,14,23
42,11/04/2015,10,21,35,56
42,11/04/2015,11,13,17,30
42,11/04/2015,12,20,18,38
42,11/04/2015,13,21,14,35
42,11/04/2015,14,22,38,60
42,11/04/2015,15,18,17,35
42,11/04/2015,16,11,18,29
42,11/04/2015,17,27,13,40
42,11/04/2015,18,8,10,18
42,11/04/2015,19,20,11,31
42,11/04/2015,20,15,6,21
42,11/04/2015,21,11,4,15
42,11/04/2015,22,8,4,12
42,11/04/2015,23,9,5,14
42,12/04/2015,0,4,7,11
42,12/04/2015,1,2,2,4
42,12/04/2015,2,3,1,4
42,12/04/2015,3,2,0,2
42,12/04/2015,4,0,1,1
42,12/04/2015,5,0,1,1
42,12/04/2015,6,1,1,2
42,12/04/2015,7,2,4,6
42,12/04/2015,8,5,8,13
42,12/04/2015,9,3,11,14
42,12/04/2015,10,5,15,20
42,12/04/2015,11,5,10,15
42,12/04/2015,12,11,15,26
42,12/04/2015,13,9,22,31
42,12/04/2015,14,16,20,36
42,12/04/2015,15,22,17,39
42,12/04/2015,16,26,27,53
42,12/04/2015,17,23,17,40
42,12/04/2015,18,23,21,44
42,12/04/2015,19,14,9,23
42,12/04/2015,20,21,11,32
42,12/04/2015,21,11,4,15
42,12/04/2015,22,4,6,10
42,12/04/2015,23,4,2,6
42,13/04/2015,0,1,3,4
42,13/04/2015,1,1,2,3
42,13/04/2015,2,0,1,1
42,13/04/2015,3,0,0,0
42,13/04/2015,4,0,0,0
42,13/04/2015,5,0,4,4
42,13/04/2015,6,2,9,11
42,13/04/2015,7,17,34,51
42,13/04/2015,8,32,91,123
42,13/04/2015,9,17,68,85
42,13/04/2015,10,15,27,42
42,13/04/2015,11,13,30,43
42,13/04/2015,12,16,22,38
42,13/04/2015,13,20,22,42
42,13/04/2015,14,23,20,43
42,13/04/2015,15,19,16,35
42,13/04/2015,16,33,20,53
42,13/04/2015,17,72,48,120
42,13/04/2015,18,62,31,93
42,13/04/2015,19,35,20,55
42,13/04/2015,20,37,8,45
42,13/04/2015,21,21,11,32
42,13/04/2015,22,6,10,16
42,13/04/2015,23,3,2,5
42,14/04/2015,0,4,4,8
42,14/04/2015,1,4,2,6
42,14/04/2015,2,0,0,0
42,14/04/2015,3,1,0,1
42,14/04/2015,4,1,0,1
42,14/04/2015,5,0,4,4
42,14/04/2015,6,1,11,12
42,14/04/2015,7,14,31,45
42,14/04/2015,8,31,94,125
42,14/04/2015,9,17,65,82
42,14/04/2015,10,10,29,39
42,14/04/2015,11,11,23,34
42,14/04/2015,12,23,26,49
42,14/04/2015,13,14,23,37
42,14/04/2015,14,28,17,45
42,14/04/2015,15,23,13,36
42,14/04/2015,16,28,17,45
42,14/04/2015,17,72,49,121
42,14/04/2015,18,58,36,94
42,14/04/2015,19,40,20,60
42,14/04/2015,20,37,17,54
42,14/04/2015,21,22,12,34
42,14/04/2015,22,7,6,13
42,14/04/2015,23,4,5,9
42,15/04/2015,0,6,2,8
42,15/04/2015,1,3,1,4
42,15/04/2015,2,2,0,2
42,15/04/2015,3,0,0,0
42,15/04/2015,4,0,0,0
42,15/04/2015,5,1,4,5
42,15/04/2015,6,3,7,10
42,15/04/2015,7,12,28,40
42,15/04/2015,8,32,74,106
42,15/04/2015,9,13,54,67
42,15/04/2015,10,8,33,41
42,15/04/2015,11,17,34,51
42,15/04/2015,12,17,23,40
42,15/04/2015,13,21,32,53
42,15/04/2015,14,25,24,49
42,15/04/2015,15,25,18,43
42,15/04/2015,16,44,32,76
42,15/04/2015,17,80,54,134
42,15/04/2015,18,78,44,122
42,15/04/2015,19,48,21,69
42,15/04/2015,20,31,20,51
42,15/04/2015,21,14,9,23
42,15/04/2015,22,15,7,22
42,15/04/2015,23,11,4,15
42,16/04/2015,0,4,4,8
42,16/04/2015,1,0,0,0
42,16/04/2015,2,0,0,0
42,16/04/2015,3,0,0,0
42,16/04/2015,4,0,0,0
42,16/04/2015,5,0,3,3
42,16/04/2015,6,4,8,12
42,16/04/2015,7,21,35,56
42,16/04/2015,8,34,90,124
42,16/04/2015,9,19,71,90
42,16/04/2015,10,10,45,55
42,16/04/2015,11,16,30,46
42,16/04/2015,12,34,31,65
42,16/04/2015,13,18,34,52
42,16/04/2015,14,36,27,63
42,16/04/2015,15,42,36,78
42,16/04/2015,16,47,40,87
42,16/04/2015,17,91,67,158
42,16/04/2015,18,66,51,117
42,16/04/2015,19,62,32,94
42,16/04/2015,20,35,19,54
42,16/04/2015,21,25,9,34
42,16/04/2015,22,11,12,23
42,16/04/2015,23,12,7,19
42,17/04/2015,0,5,1,6
42,17/04/2015,1,5,1,6
42,17/04/2015,2,2,0,2
42,17/04/2015,3,0,0,0
42,17/04/2015,4,0,0,0
42,17/04/2015,5,1,3,4
42,17/04/2015,6,4,10,14
42,17/04/2015,7,14,30,44
42,17/04/2015,8,25,72,97
42,17/04/2015,9,7,55,62
42,17/04/2015,10,18,32,50
42,17/04/2015,11,20,20,40
42,17/04/2015,12,30,24,54
42,17/04/2015,13,17,25,42
42,17/04/2015,14,26,40,66
42,17/04/2015,15,26,30,56
42,17/04/2015,16,48,35,83
42,17/04/2015,17,72,55,127
42,17/04/2015,18,46,36,82
42,17/04/2015,19,35,28,63
42,17/04/2015,20,33,14,47
42,17/04/2015,21,23,11,34
42,17/04/2015,22,17,5,22
42,17/04/2015,23,14,4,18
42,18/04/2015,0,12,3,15
42,18/04/2015,1,5,1,6
42,18/04/2015,2,4,1,5
42,18/04/2015,3,1,1,2
42,18/04/2015,4,0,0,0
42,18/04/2015,5,0,0,0
42,18/04/2015,6,1,3,4
42,18/04/2015,7,3,11,14
42,18/04/2015,8,6,21,27
42,18/04/2015,9,8,33,41
42,18/04/2015,10,21,36,57
42,18/04/2015,11,25,34,59
42,18/04/2015,12,37,35,72
42,18/04/2015,13,27,21,48
42,18/04/2015,14,32,35,67
42,18/04/2015,15,40,32,72
42,18/04/2015,16,25,31,56
42,18/04/2015,17,39,25,64
42,18/04/2015,18,32,20,52
42,18/04/2015,19,21,29,50
42,18/04/2015,20,29,15,44
42,18/04/2015,21,10,13,23
42,18/04/2015,22,7,15,22
42,18/04/2015,23,10,5,15
42,19/04/2015,0,11,5,16
42,19/04/2015,1,4,3,7
42,19/04/2015,2,2,3,5
42,19/04/2015,3,1,1,2
42,19/04/2015,4,1,1,2
42,19/04/2015,5,1,0,1
42,19/04/2015,6,0,1,1
42,19/04/2015,7,4,6,10
42,19/04/2015,8,6,8,14
42,19/04/2015,9,8,5,13
42,19/04/2015,10,7,12,19
42,19/04/2015,11,7,30,37
42,19/04/2015,12,30,28,58
42,19/04/2015,13,21,36,57
42,19/04/2015,14,17,21,38
42,19/04/2015,15,23,23,46
42,19/04/2015,16,23,13,36
42,19/04/2015,17,27,27,54
42,19/04/2015,18,33,21,54
42,19/04/2015,19,21,23,44
42,19/04/2015,20,18,14,32
42,19/04/2015,21,12,9,21
42,19/04/2015,22,12,3,15
42,19/04/2015,23,11,6,17
42,20/04/2015,0,5,2,7
42,20/04/2015,1,5,0,5
42,20/04/2015,2,1,0,1
42,20/04/2015,3,0,0,0
42,20/04/2015,4,0,0,0
42,20/04/2015,5,1,5,6
42,20/04/2015,6,3,5,8
42,20/04/2015,7,19,35,54
42,20/04/2015,8,35,87,122
42,20/04/2015,9,14,93,107
42,20/04/2015,10,15,42,57
42,20/04/2015,11,11,29,40
42,20/04/2015,12,19,16,35
42,20/04/2015,13,22,40,62
42,20/04/2015,14,31,22,53
42,20/04/2015,15,27,18,45
42,20/04/2015,16,42,34,76
42,20/04/2015,17,107,64,171
42,20/04/2015,18,80,39,119
42,20/04/2015,19,51,38,89
42,20/04/2015,20,38,17,55
42,20/04/2015,21,26,19,45
42,20/04/2015,22,9,6,15
42,20/04/2015,23,10,7,17
42,21/04/2015,0,1,3,4
42,21/04/2015,1,1,2,3
42,21/04/2015,2,2,0,2
42,21/04/2015,3,2,0,2
42,21/04/2015,4,0,0,0
42,21/04/2015,5,0,5,5
42,21/04/2015,6,2,12,14
42,21/04/2015,7,14,53,67
42,21/04/2015,8,41,132,173
42,21/04/2015,9,25,115,140
42,21/04/2015,10,18,43,61
42,21/04/2015,11,19,23,42
42,21/04/2015,12,28,27,55
42,21/04/2015,13,35,32,67
42,21/04/2015,14,39,44,83
42,21/04/2015,15,40,21,61
42,21/04/2015,16,60,43,103
42,21/04/2015,17,124,78,202
42,21/04/2015,18,81,64,145
42,21/04/2015,19,65,51,116
42,21/04/2015,20,43,29,72
42,21/04/2015,21,34,13,47
42,21/04/2015,22,16,9,25
42,21/04/2015,23,10,3,13
42,22/04/2015,0,0,5,5
42,22/04/2015,1,2,0,2
42,22/04/2015,2,1,0,1
42,22/04/2015,3,1,0,1
42,22/04/2015,4,0,0,0
42,22/04/2015,5,0,3,3
42,22/04/2015,6,5,12,17
42,22/04/2015,7,24,62,86
42,22/04/2015,8,44,117,161
42,22/04/2015,9,24,96,120
42,22/04/2015,10,18,45,63
42,22/04/2015,11,17,29,46
42,22/04/2015,12,28,46,74
42,22/04/2015,13,26,37,63
42,22/04/2015,14,40,35,75
42,22/04/2015,15,34,36,70
42,22/04/2015,16,80,41,121
42,22/04/2015,17,109,81,190
42,22/04/2015,18,75,59,134
42,22/04/2015,19,75,41,116
42,22/04/2015,20,52,24,76
42,22/04/2015,21,34,11,45
42,22/04/2015,22,31,9,40
42,22/04/2015,23,9,12,21
42,23/04/2015,0,13,6,19
42,23/04/2015,1,2,1,3
42,23/04/2015,2,0,1,1
42,23/04/2015,3,1,0,1
42,23/04/2015,4,0,1,1
42,23/04/2015,5,1,6,7
42,23/04/2015,6,1,11,12
42,23/04/2015,7,21,60,81
42,23/04/2015,8,38,121,159
42,23/04/2015,9,22,100,122
42,23/04/2015,10,19,40,59
42,23/04/2015,11,16,31,47
42,23/04/2015,12,21,29,50
42,23/04/2015,13,34,36,70
42,23/04/2015,14,47,33,80
42,23/04/2015,15,53,39,92
42,23/04/2015,16,59,48,107
42,23/04/2015,17,115,79,194
42,23/04/2015,18,68,56,124
42,23/04/2015,19,83,54,137
42,23/04/2015,20,52,30,82
42,23/04/2015,21,27,17,44
42,23/04/2015,22,24,13,37
42,23/04/2015,23,12,13,25
42,24/04/2015,0,8,3,11
42,24/04/2015,1,4,2,6
42,24/04/2015,2,3,0,3
42,24/04/2015,3,1,0,1
42,24/04/2015,4,0,0,0
42,24/04/2015,5,0,3,3
42,24/04/2015,6,6,12,18
42,24/04/2015,7,14,47,61
42,24/04/2015,8,35,107,142
42,24/04/2015,9,24,79,103
42,24/04/2015,10,13,34,47
42,24/04/2015,11,22,25,47
42,24/04/2015,12,40,33,73
42,24/04/2015,13,26,27,53
42,24/04/2015,14,39,33,72
42,24/04/2015,15,32,37,69
42,24/04/2015,16,56,49,105
42,24/04/2015,17,90,50,140
42,24/04/2015,18,51,39,90
42,24/04/2015,19,49,23,72
42,24/04/2015,20,22,12,34
42,24/04/2015,21,31,8,39
42,24/04/2015,22,10,6,16
42,24/04/2015,23,14,4,18
42,25/04/2015,0,8,5,13
42,25/04/2015,1,2,1,3
42,25/04/2015,2,2,1,3
42,25/04/2015,3,1,1,2
42,25/04/2015,4,0,1,1
42,25/04/2015,5,1,2,3
42,25/04/2015,6,1,3,4
42,25/04/2015,7,1,7,8
42,25/04/2015,8,0,22,22
42,25/04/2015,9,5,29,34
42,25/04/2015,10,13,40,53
42,25/04/2015,11,18,184,202
42,25/04/2015,12,31,64,95
42,25/04/2015,13,64,21,85
42,25/04/2015,14,57,39,96
42,25/04/2015,15,59,25,84
42,25/04/2015,16,39,23,62
42,25/04/2015,17,38,23,61
42,25/04/2015,18,25,16,41
42,25/04/2015,19,19,19,38
42,25/04/2015,20,21,13,34
42,25/04/2015,21,15,6,21
42,25/04/2015,22,10,4,14
42,25/04/2015,23,14,6,20
42,26/04/2015,0,6,8,14
42,26/04/2015,1,8,2,10
42,26/04/2015,2,4,0,4
42,26/04/2015,3,2,1,3
42,26/04/2015,4,2,0,2
42,26/04/2015,5,0,0,0
42,26/04/2015,6,0,4,4
42,26/04/2015,7,4,9,13
42,26/04/2015,8,7,21,28
42,26/04/2015,9,14,27,41
42,26/04/2015,10,15,41,56
42,26/04/2015,11,23,42,65
42,26/04/2015,12,33,30,63
42,26/04/2015,13,27,27,54
42,26/04/2015,14,27,27,54
42,26/04/2015,15,26,30,56
42,26/04/2015,16,29,20,49
42,26/04/2015,17,25,21,46
42,26/04/2015,18,22,12,34
42,26/04/2015,19,17,12,29
42,26/04/2015,20,18,12,30
42,26/04/2015,21,12,4,16
42,26/04/2015,22,14,5,19
42,26/04/2015,23,12,4,16
42,27/04/2015,0,2,3,5
42,27/04/2015,1,0,1,1
42,27/04/2015,2,1,0,1
42,27/04/2015,3,0,0,0
42,27/04/2015,4,0,0,0
42,27/04/2015,5,2,2,4
42,27/04/2015,6,2,12,14
42,27/04/2015,7,13,48,61
42,27/04/2015,8,35,125,160
42,27/04/2015,9,15,92,107
42,27/04/2015,10,18,31,49
42,27/04/2015,11,14,28,42
42,27/04/2015,12,18,15,33
42,27/04/2015,13,20,22,42
42,27/04/2015,14,27,23,50
42,27/04/2015,15,36,36,72
42,27/04/2015,16,60,33,93
42,27/04/2015,17,92,40,132
42,27/04/2015,18,49,39,88
42,27/04/2015,19,42,28,70
42,27/04/2015,20,29,12,41
42,27/04/2015,21,34,9,43
42,27/04/2015,22,12,4,16
42,27/04/2015,23,5,3,8
42,28/04/2015,0,4,2,6
42,28/04/2015,1,2,0,2
42,28/04/2015,2,1,0,1
42,28/04/2015,3,0,0,0
42,28/04/2015,4,0,0,0
42,28/04/2015,5,1,3,4
42,28/04/2015,6,2,11,13
42,28/04/2015,7,14,55,69
42,28/04/2015,8,41,129,170
42,28/04/2015,9,25,85,110
42,28/04/2015,10,13,37,50
42,28/04/2015,11,10,24,34
42,28/04/2015,12,29,22,51
42,28/04/2015,13,31,26,57
42,28/04/2015,14,25,24,49
42,28/04/2015,15,37,26,63
42,28/04/2015,16,46,36,82
42,28/04/2015,17,83,48,131
42,28/04/2015,18,69,45,114
42,28/04/2015,19,38,30,68
42,28/04/2015,20,29,18,47
42,28/04/2015,21,25,10,35
42,28/04/2015,22,15,10,25
42,28/04/2015,23,11,3,14
42,29/04/2015,0,5,3,8
42,29/04/2015,1,3,1,4
42,29/04/2015,2,3,1,4
42,29/04/2015,3,1,0,1
42,29/04/2015,4,0,0,0
42,29/04/2015,5,1,3,4
42,29/04/2015,6,6,13,19
42,29/04/2015,7,17,38,55
42,29/04/2015,8,31,110,141
42,29/04/2015,9,27,76,103
42,29/04/2015,10,15,32,47
42,29/04/2015,11,13,19,32
42,29/04/2015,12,13,16,29
42,29/04/2015,13,19,18,37
42,29/04/2015,14,17,20,37
42,29/04/2015,15,20,22,42
42,29/04/2015,16,40,28,68
42,29/04/2015,17,82,55,137
42,29/04/2015,18,48,47,95
42,29/04/2015,19,44,23,67
42,29/04/2015,20,23,18,41
42,29/04/2015,21,24,11,35
42,29/04/2015,22,24,10,34
42,29/04/2015,23,11,2,13
42,30/04/2015,0,10,2,12
42,30/04/2015,1,5,2,7
42,30/04/2015,2,1,0,1
42,30/04/2015,3,0,0,0
42,30/04/2015,4,1,0,1
42,30/04/2015,5,1,5,6
42,30/04/2015,6,6,11,17
42,30/04/2015,7,16,44,60
42,30/04/2015,8,45,107,152
42,30/04/2015,9,27,88,115
42,30/04/2015,10,21,31,52
42,30/04/2015,11,15,24,39
42,30/04/2015,12,33,34,67
42,30/04/2015,13,28,22,50
42,30/04/2015,14,32,30,62
42,30/04/2015,15,33,25,58
42,30/04/2015,16,63,35,98
42,30/04/2015,17,86,50,136
42,30/04/2015,18,62,50,112
42,30/04/2015,19,56,30,86
42,30/04/2015,20,46,25,71
42,30/04/2015,21,24,17,41
42,30/04/2015,22,18,6,24
42,30/04/2015,23,9,5,14
42,01/05/2015,0,12,4,16
42,01/05/2015,1,3,1,4
42,01/05/2015,2,2,0,2
42,01/05/2015,3,1,0,1
42,01/05/2015,4,0,0,0
42,01/05/2015,5,1,4,5
42,01/05/2015,6,5,15,20
42,01/05/2015,7,9,41,50
42,01/05/2015,8,38,95,133
42,01/05/2015,9,20,81,101
42,01/05/2015,10,21,32,53
42,01/05/2015,11,22,21,43
42,01/05/2015,12,33,28,61
42,01/05/2015,13,29,26,55
42,01/05/2015,14,32,33,65
42,01/05/2015,15,32,25,57
42,01/05/2015,16,47,37,84
42,01/05/2015,17,91,50,141
42,01/05/2015,18,34,34,68
42,01/05/2015,19,39,22,61
42,01/05/2015,20,23,17,40
42,01/05/2015,21,18,7,25
42,01/05/2015,22,15,4,19
42,01/05/2015,23,9,6,15
42,02/05/2015,0,5,7,12
42,02/05/2015,1,3,2,5
42,02/05/2015,2,2,2,4
42,02/05/2015,3,4,0,4
42,02/05/2015,4,0,0,0
42,02/05/2015,5,0,2,2
42,02/05/2015,6,0,2,2
42,02/05/2015,7,6,7,13
42,02/05/2015,8,1,21,22
42,02/05/2015,9,16,30,46
42,02/05/2015,10,19,28,47
42,02/05/2015,11,17,26,43
42,02/05/2015,12,22,30,52
42,02/05/2015,13,21,26,47
42,02/05/2015,14,10,23,33
42,02/05/2015,15,24,17,41
42,02/05/2015,16,26,27,53
42,02/05/2015,17,30,17,47
42,02/05/2015,18,25,18,43
42,02/05/2015,19,11,14,25
42,02/05/2015,20,9,4,13
42,02/05/2015,21,11,8,19
42,02/05/2015,22,8,2,10
42,02/05/2015,23,6,4,10
42,03/05/2015,0,2,4,6
42,03/05/2015,1,2,1,3
42,03/05/2015,2,2,2,4
42,03/05/2015,3,2,0,2
42,03/05/2015,4,0,0,0
42,03/05/2015,5,0,1,1
42,03/05/2015,6,0,0,0
42,03/05/2015,7,3,6,9
42,03/05/2015,8,3,14,17
42,03/05/2015,9,7,11,18
42,03/05/2015,10,8,28,36
42,03/05/2015,11,11,19,30
42,03/05/2015,12,13,15,28
42,03/05/2015,13,9,12,21
42,03/05/2015,14,7,10,17
42,03/05/2015,15,8,9,17
42,03/05/2015,16,13,16,29
42,03/05/2015,17,19,8,27
42,03/05/2015,18,20,4,24
42,03/05/2015,19,20,4,24
42,03/05/2015,20,12,7,19
42,03/05/2015,21,8,14,22
42,03/05/2015,22,5,5,10
42,03/05/2015,23,3,3,6
42,04/05/2015,0,3,0,3
42,04/05/2015,1,4,1,5
42,04/05/2015,2,1,0,1
42,04/05/2015,3,1,1,2
42,04/05/2015,4,1,0,1
42,04/05/2015,5,0,4,4
42,04/05/2015,6,3,12,15
42,04/05/2015,7,14,31,45
42,04/05/2015,8,27,78,105
42,04/05/2015,9,12,70,82
42,04/05/2015,10,15,34,49
42,04/05/2015,11,26,33,59
42,04/05/2015,12,25,32,57
42,04/05/2015,13,32,39,71
42,04/05/2015,14,28,26,54
42,04/05/2015,15,42,23,65
42,04/05/2015,16,51,32,83
42,04/05/2015,17,85,50,135
42,04/05/2015,18,56,42,98
42,04/05/2015,19,45,28,73
42,04/05/2015,20,36,10,46
42,04/05/2015,21,30,9,39
42,04/05/2015,22,14,8,22
42,04/05/2015,23,5,5,10
42,05/05/2015,0,3,2,5
42,05/05/2015,1,0,0,0
42,05/05/2015,2,3,1,4
42,05/05/2015,3,2,0,2
42,05/05/2015,4,1,0,1
42,05/05/2015,5,2,5,7
42,05/05/2015,6,4,13,17
42,05/05/2015,7,8,32,40
42,05/05/2015,8,27,80,107
42,05/05/2015,9,16,58,74
42,05/05/2015,10,7,19,26
42,05/05/2015,11,11,12,23
42,05/05/2015,12,13,15,28
42,05/05/2015,13,11,11,22
42,05/05/2015,14,9,19,28
42,05/05/2015,15,15,5,20
42,05/05/2015,16,27,18,45
42,05/05/2015,17,72,43,115
42,05/05/2015,18,41,37,78
42,05/05/2015,19,31,20,51
42,05/05/2015,20,26,14,40
42,05/05/2015,21,20,12,32
42,05/05/2015,22,19,8,27
42,05/05/2015,23,9,6,15
42,06/05/2015,0,4,1,5
42,06/05/2015,1,3,0,3
42,06/05/2015,2,2,0,2
42,06/05/2015,3,0,0,0
42,06/05/2015,4,0,0,0
42,06/05/2015,5,0,3,3
42,06/05/2015,6,4,12,16
42,06/05/2015,7,16,42,58
42,06/05/2015,8,30,109,139
42,06/05/2015,9,23,75,98
42,06/05/2015,10,11,35,46
42,06/05/2015,11,15,21,36
42,06/05/2015,12,17,27,44
42,06/05/2015,13,23,26,49
42,06/05/2015,14,17,21,38
42,06/05/2015,15,27,25,52
42,06/05/2015,16,37,20,57
42,06/05/2015,17,98,58,156
42,06/05/2015,18,50,35,85
42,06/05/2015,19,36,27,63
42,06/05/2015,20,33,11,44
42,06/05/2015,21,16,9,25
42,06/05/2015,22,17,9,26
42,06/05/2015,23,12,5,17
42,07/05/2015,0,2,2,4
42,07/05/2015,1,1,1,2
42,07/05/2015,2,3,0,3
42,07/05/2015,3,0,0,0
42,07/05/2015,4,0,0,0
42,07/05/2015,5,0,3,3
42,07/05/2015,6,3,11,14
42,07/05/2015,7,22,41,63
42,07/05/2015,8,45,104,149
42,07/05/2015,9,22,85,107
42,07/05/2015,10,14,26,40
42,07/05/2015,11,21,31,52
42,07/05/2015,12,24,31,55
42,07/05/2015,13,20,33,53
42,07/05/2015,14,29,17,46
42,07/05/2015,15,34,29,63
42,07/05/2015,16,59,34,93
42,07/05/2015,17,117,59,176
42,07/05/2015,18,66,53,119
42,07/05/2015,19,46,32,78
42,07/05/2015,20,47,16,63
42,07/05/2015,21,24,15,39
42,07/05/2015,22,14,13,27
42,07/05/2015,23,12,7,19
42,08/05/2015,0,9,2,11
42,08/05/2015,1,2,2,4
42,08/05/2015,2,0,0,0
42,08/05/2015,3,1,0,1
42,08/05/2015,4,1,5,6
42,08/05/2015,5,1,7,8
42,08/05/2015,6,5,9,14
42,08/05/2015,7,11,38,49
42,08/05/2015,8,32,92,124
42,08/05/2015,9,21,80,101
42,08/05/2015,10,13,39,52
42,08/05/2015,11,28,30,58
42,08/05/2015,12,19,29,48
42,08/05/2015,13,32,36,68
42,08/05/2015,14,26,34,60
42,08/05/2015,15,27,25,52
42,08/05/2015,16,59,41,100
42,08/05/2015,17,84,56,140
42,08/05/2015,18,57,41,98
42,08/05/2015,19,29,27,56
42,08/05/2015,20,19,9,28
42,08/05/2015,21,9,8,17
42,08/05/2015,22,9,8,17
42,08/05/2015,23,10,10,20
42,09/05/2015,0,4,4,8
42,09/05/2015,1,5,1,6
42,09/05/2015,2,1,1,2
42,09/05/2015,3,4,0,4
42,09/05/2015,4,2,1,3
42,09/05/2015,5,1,2,3
42,09/05/2015,6,1,2,3
42,09/05/2015,7,2,14,16
42,09/05/2015,8,5,9,14
42,09/05/2015,9,18,30,48
42,09/05/2015,10,14,33,47
42,09/05/2015,11,20,28,48
42,09/05/2015,12,22,30,52
42,09/05/2015,13,33,33,66
42,09/05/2015,14,37,30,67
42,09/05/2015,15,25,21,46
42,09/05/2015,16,31,33,64
42,09/05/2015,17,34,14,48
42,09/05/2015,18,15,21,36
42,09/05/2015,19,19,13,32
42,09/05/2015,20,11,11,22
42,09/05/2015,21,18,9,27
42,09/05/2015,22,10,6,16
42,09/05/2015,23,13,5,18
42,10/05/2015,0,9,5,14
42,10/05/2015,1,4,4,8
42,10/05/2015,2,4,2,6
42,10/05/2015,3,3,0,3
42,10/05/2015,4,0,0,0
42,10/05/2015,5,1,2,3
42,10/05/2015,6,0,2,2
42,10/05/2015,7,1,4,5
42,10/05/2015,8,4,9,13
42,10/05/2015,9,8,16,24
42,10/05/2015,10,6,22,28
42,10/05/2015,11,27,46,73
42,10/05/2015,12,16,16,32
42,10/05/2015,13,10,21,31
42,10/05/2015,14,27,38,65
42,10/05/2015,15,15,25,40
42,10/05/2015,16,27,24,51
42,10/05/2015,17,33,22,55
42,10/05/2015,18,26,15,41
42,10/05/2015,19,21,7,28
42,10/05/2015,20,19,11,30
42,10/05/2015,21,11,6,17
42,10/05/2015,22,9,3,12
42,10/05/2015,23,2,5,7
42,11/05/2015,0,6,3,9
42,11/05/2015,1,1,0,1
42,11/05/2015,2,1,0,1
42,11/05/2015,3,0,0,0
42,11/05/2015,4,0,0,0
42,11/05/2015,5,2,6,8
42,11/05/2015,6,3,10,13
42,11/05/2015,7,13,38,51
42,11/05/2015,8,44,108,152
42,11/05/2015,9,21,79,100
42,11/05/2015,10,28,35,63
42,11/05/2015,11,8,24,32
42,11/05/2015,12,24,20,44
42,11/05/2015,13,20,24,44
42,11/05/2015,14,31,13,44
42,11/05/2015,15,34,21,55
42,11/05/2015,16,47,29,76
42,11/05/2015,17,94,51,145
42,11/05/2015,18,70,45,115
42,11/05/2015,19,50,33,83
42,11/05/2015,20,24,14,38
42,11/05/2015,21,30,15,45
42,11/05/2015,22,16,7,23
42,11/05/2015,23,13,6,19
42,12/05/2015,0,2,3,5
42,12/05/2015,1,3,1,4
42,12/05/2015,2,0,0,0
42,12/05/2015,3,0,0,0
42,12/05/2015,4,0,1,1
42,12/05/2015,5,2,6,8
42,12/05/2015,6,3,14,17
42,12/05/2015,7,17,42,59
42,12/05/2015,8,45,113,158
42,12/05/2015,9,16,90,106
42,12/05/2015,10,13,36,49
42,12/05/2015,11,17,25,42
42,12/05/2015,12,16,26,42
42,12/05/2015,13,21,25,46
42,12/05/2015,14,25,22,47
42,12/05/2015,15,30,23,53
42,12/05/2015,16,51,28,79
42,12/05/2015,17,105,50,155
42,12/05/2015,18,64,46,110
42,12/05/2015,19,42,21,63
42,12/05/2015,20,38,23,61
42,12/05/2015,21,26,13,39
42,12/05/2015,22,16,4,20
42,12/05/2015,23,5,5,10
42,13/05/2015,0,6,4,10
42,13/05/2015,1,4,0,4
42,13/05/2015,2,1,0,1
42,13/05/2015,3,0,0,0
42,13/05/2015,4,1,0,1
42,13/05/2015,5,1,6,7
42,13/05/2015,6,3,17,20
42,13/05/2015,7,13,52,65
42,13/05/2015,8,39,120,159
42,13/05/2015,9,25,92,117
42,13/05/2015,10,14,33,47
42,13/05/2015,11,21,23,44
42,13/05/2015,12,24,29,53
42,13/05/2015,13,20,33,53
42,13/05/2015,14,32,29,61
42,13/05/2015,15,33,24,57
42,13/05/2015,16,61,35,96
42,13/05/2015,17,98,65,163
42,13/05/2015,18,72,50,122
42,13/05/2015,19,36,31,67
42,13/05/2015,20,29,21,50
42,13/05/2015,21,27,13,40
42,13/05/2015,22,15,4,19
42,13/05/2015,23,11,3,14
42,14/05/2015,0,4,4,8
42,14/05/2015,1,1,1,2
42,14/05/2015,2,2,0,2
42,14/05/2015,3,1,0,1
42,14/05/2015,4,0,0,0
42,14/05/2015,5,0,4,4
42,14/05/2015,6,2,12,14
42,14/05/2015,7,11,43,54
42,14/05/2015,8,41,112,153
42,14/05/2015,9,18,79,97
42,14/05/2015,10,10,31,41
42,14/05/2015,11,17,28,45
42,14/05/2015,12,23,21,44
42,14/05/2015,13,30,22,52
42,14/05/2015,14,29,18,47
42,14/05/2015,15,21,31,52
42,14/05/2015,16,62,28,90
42,14/05/2015,17,90,55,145
42,14/05/2015,18,67,56,123
42,14/05/2015,19,37,28,65
42,14/05/2015,20,40,19,59
42,14/05/2015,21,22,19,41
42,14/05/2015,22,14,5,19
42,14/05/2015,23,10,6,16
42,15/05/2015,0,6,3,9
42,15/05/2015,1,3,1,4
42,15/05/2015,2,1,1,2
42,15/05/2015,3,0,0,0
42,15/05/2015,4,0,0,0
42,15/05/2015,5,0,5,5
42,15/05/2015,6,5,12,17
42,15/05/2015,7,15,50,65
42,15/05/2015,8,38,101,139
42,15/05/2015,9,19,66,85
42,15/05/2015,10,21,32,53
42,15/05/2015,11,17,28,45
42,15/05/2015,12,18,33,51
42,15/05/2015,13,24,33,57
42,15/05/2015,14,29,25,54
42,15/05/2015,15,27,30,57
42,15/05/2015,16,46,40,86
42,15/05/2015,17,79,43,122
42,15/05/2015,18,58,27,85
42,15/05/2015,19,33,24,57
42,15/05/2015,20,15,10,25
42,15/05/2015,21,12,11,23
42,15/05/2015,22,9,10,19
42,15/05/2015,23,7,2,9
42,16/05/2015,0,8,0,8
42,16/05/2015,1,4,2,6
42,16/05/2015,2,1,0,1
42,16/05/2015,3,2,2,4
42,16/05/2015,4,1,0,1
42,16/05/2015,5,2,0,2
42,16/05/2015,6,1,4,5
42,16/05/2015,7,3,10,13
42,16/05/2015,8,5,13,18
42,16/05/2015,9,13,26,39
42,16/05/2015,10,20,30,50
42,16/05/2015,11,20,29,49
42,16/05/2015,12,16,28,44
42,16/05/2015,13,19,28,47
42,16/05/2015,14,26,34,60
42,16/05/2015,15,25,32,57
42,16/05/2015,16,17,18,35
42,16/05/2015,17,33,30,63
42,16/05/2015,18,24,16,40
42,16/05/2015,19,17,18,35
42,16/05/2015,20,15,13,28
42,16/05/2015,21,11,5,16
42,16/05/2015,22,16,9,25
42,16/05/2015,23,8,6,14
42,17/05/2015,0,8,4,12
42,17/05/2015,1,6,2,8
42,17/05/2015,2,0,1,1
42,17/05/2015,3,1,1,2
42,17/05/2015,4,2,0,2
42,17/05/2015,5,1,0,1
42,17/05/2015,6,1,2,3
42,17/05/2015,7,1,5,6
42,17/05/2015,8,5,11,16
42,17/05/2015,9,13,20,33
42,17/05/2015,10,8,31,39
42,17/05/2015,11,10,30,40
42,17/05/2015,12,12,28,40
42,17/05/2015,13,17,16,33
42,17/05/2015,14,15,22,37
42,17/05/2015,15,21,22,43
42,17/05/2015,16,34,30,64
42,17/05/2015,17,20,19,39
42,17/05/2015,18,30,12,42
42,17/05/2015,19,23,15,38
42,17/05/2015,20,14,9,23
42,17/05/2015,21,5,11,16
42,17/05/2015,22,11,8,19
42,17/05/2015,23,8,2,10
42,18/05/2015,0,4,4,8
42,18/05/2015,1,0,1,1
42,18/05/2015,2,0,0,0
42,18/05/2015,3,1,1,2
42,18/05/2015,4,1,0,1
42,18/05/2015,5,0,3,3
42,18/05/2015,6,2,12,14
42,18/05/2015,7,15,36,51
42,18/05/2015,8,22,90,112
42,18/05/2015,9,18,72,90
42,18/05/2015,10,9,23,32
42,18/05/2015,11,5,11,16
42,18/05/2015,12,7,22,29
42,18/05/2015,13,20,18,38
42,18/05/2015,14,28,25,53
42,18/05/2015,15,20,27,47
42,18/05/2015,16,43,27,70
42,18/05/2015,17,78,50,128
42,18/05/2015,18,60,33,93
42,18/05/2015,19,44,22,66
42,18/05/2015,20,23,17,40
42,18/05/2015,21,22,13,35
42,18/05/2015,22,8,4,12
42,18/05/2015,23,10,6,16
42,19/05/2015,0,4,2,6
42,19/05/2015,1,0,0,0
42,19/05/2015,2,2,1,3
42,19/05/2015,3,0,0,0
42,19/05/2015,4,0,0,0
42,19/05/2015,5,1,7,8
42,19/05/2015,6,6,14,20
42,19/05/2015,7,20,39,59
42,19/05/2015,8,38,118,156
42,19/05/2015,9,33,74,107
42,19/05/2015,10,16,27,43
42,19/05/2015,11,15,16,31
42,19/05/2015,12,10,29,39
42,19/05/2015,13,20,35,55
42,19/05/2015,14,28,19,47
42,19/05/2015,15,29,29,58
42,19/05/2015,16,60,27,87
42,19/05/2015,17,103,50,153
42,19/05/2015,18,65,50,115
42,19/05/2015,19,28,18,46
42,19/05/2015,20,36,18,54
42,19/05/2015,21,31,15,46
42,19/05/2015,22,9,9,18
42,19/05/2015,23,7,10,17
42,20/05/2015,0,3,2,5
42,20/05/2015,1,2,0,2
42,20/05/2015,2,0,0,0
42,20/05/2015,3,1,0,1
42,20/05/2015,4,0,2,2
42,20/05/2015,5,3,7,10
42,20/05/2015,6,6,13,19
42,20/05/2015,7,18,45,63
42,20/05/2015,8,47,119,166
42,20/05/2015,9,22,62,84
42,20/05/2015,10,12,45,57
42,20/05/2015,11,26,22,48
42,20/05/2015,12,25,28,53
42,20/05/2015,13,28,33,61
42,20/05/2015,14,21,29,50
42,20/05/2015,15,38,21,59
42,20/05/2015,16,63,38,101
42,20/05/2015,17,105,74,179
42,20/05/2015,18,70,49,119
42,20/05/2015,19,37,19,56
42,20/05/2015,20,25,29,54
42,20/05/2015,21,26,22,48
42,20/05/2015,22,15,12,27
42,20/05/2015,23,10,10,20
42,21/05/2015,0,6,2,8
42,21/05/2015,1,3,3,6
42,21/05/2015,2,1,0,1
42,21/05/2015,3,3,0,3
42,21/05/2015,4,0,0,0
42,21/05/2015,5,5,2,7
42,21/05/2015,6,4,13,17
42,21/05/2015,7,16,39,55
42,21/05/2015,8,34,100,134
42,21/05/2015,9,19,64,83
42,21/05/2015,10,10,22,32
42,21/05/2015,11,15,18,33
42,21/05/2015,12,24,33,57
42,21/05/2015,13,26,32,58
42,21/05/2015,14,30,26,56
42,21/05/2015,15,28,29,57
42,21/05/2015,16,49,27,76
42,21/05/2015,17,85,38,123
42,21/05/2015,18,52,48,100
42,21/05/2015,19,32,28,60
42,21/05/2015,20,47,16,63
42,21/05/2015,21,16,25,41
42,21/05/2015,22,20,10,30
42,21/05/2015,23,5,8,13
42,22/05/2015,0,3,6,9
42,22/05/2015,1,6,0,6
42,22/05/2015,2,0,1,1
42,22/05/2015,3,0,3,3
42,22/05/2015,4,3,1,4
42,22/05/2015,5,0,2,2
42,22/05/2015,6,4,15,19
42,22/05/2015,7,15,33,48
42,22/05/2015,8,42,93,135
42,22/05/2015,9,19,63,82
42,22/05/2015,10,17,22,39
42,22/05/2015,11,19,20,39
42,22/05/2015,12,36,29,65
42,22/05/2015,13,22,31,53
42,22/05/2015,14,35,26,61
42,22/05/2015,15,35,28,63
42,22/05/2015,16,56,42,98
42,22/05/2015,17,75,55,130
42,22/05/2015,18,44,29,73
42,22/05/2015,19,26,29,55
42,22/05/2015,20,22,13,35
42,22/05/2015,21,13,5,18
42,22/05/2015,22,8,6,14
42,22/05/2015,23,10,5,15
42,23/05/2015,0,7,9,16
42,23/05/2015,1,2,2,4
42,23/05/2015,2,2,0,2
42,23/05/2015,3,3,0,3
42,23/05/2015,4,1,0,1
42,23/05/2015,5,0,1,1
42,23/05/2015,6,4,4,8
42,23/05/2015,7,6,8,14
42,23/05/2015,8,6,24,30
42,23/05/2015,9,28,15,43
42,23/05/2015,10,26,35,61
42,23/05/2015,11,15,33,48
42,23/05/2015,12,26,36,62
42,23/05/2015,13,25,49,74
42,23/05/2015,14,32,25,57
42,23/05/2015,15,33,29,62
42,23/05/2015,16,37,31,68
42,23/05/2015,17,35,26,61
42,23/05/2015,18,38,28,66
42,23/05/2015,19,29,15,44
42,23/05/2015,20,13,17,30
42,23/05/2015,21,13,13,26
42,23/05/2015,22,12,7,19
42,23/05/2015,23,2,7,9
42,24/05/2015,0,9,6,15
42,24/05/2015,1,2,2,4
42,24/05/2015,2,1,1,2
42,24/05/2015,3,2,2,4
42,24/05/2015,4,0,0,0
42,24/05/2015,5,0,0,0
42,24/05/2015,6,1,2,3
42,24/05/2015,7,1,5,6
42,24/05/2015,8,4,11,15
42,24/05/2015,9,12,12,24
42,24/05/2015,10,17,31,48
42,24/05/2015,11,14,24,38
42,24/05/2015,12,21,24,45
42,24/05/2015,13,22,19,41
42,24/05/2015,14,18,19,37
42,24/05/2015,15,26,25,51
42,24/05/2015,16,42,22,64
42,24/05/2015,17,23,16,39
42,24/05/2015,18,18,20,38
42,24/05/2015,19,17,16,33
42,24/05/2015,20,16,9,25
42,24/05/2015,21,5,5,10
42,24/05/2015,22,7,3,10
42,24/05/2015,23,14,2,16
42,25/05/2015,0,5,3,8
42,25/05/2015,1,1,1,2
42,25/05/2015,2,4,0,4
42,25/05/2015,3,0,1,1
42,25/05/2015,4,1,1,2
42,25/05/2015,5,3,3,6
42,25/05/2015,6,6,10,16
42,25/05/2015,7,13,43,56
42,25/05/2015,8,35,97,132
42,25/05/2015,9,19,61,80
42,25/05/2015,10,15,29,44
42,25/05/2015,11,18,25,43
42,25/05/2015,12,23,34,57
42,25/05/2015,13,30,34,64
42,25/05/2015,14,38,25,63
42,25/05/2015,15,30,39,69
42,25/05/2015,16,49,47,96
42,25/05/2015,17,117,55,172
42,25/05/2015,18,65,43,108
42,25/05/2015,19,41,30,71
42,25/05/2015,20,35,21,56
42,25/05/2015,21,18,7,25
42,25/05/2015,22,7,11,18
42,25/05/2015,23,11,6,17
42,26/05/2015,0,5,1,6
42,26/05/2015,1,1,1,2
42,26/05/2015,2,0,3,3
42,26/05/2015,3,0,1,1
42,26/05/2015,4,1,0,1
42,26/05/2015,5,3,5,8
42,26/05/2015,6,5,9,14
42,26/05/2015,7,10,50,60
42,26/05/2015,8,47,113,160
42,26/05/2015,9,22,87,109
42,26/05/2015,10,16,35,51
42,26/05/2015,11,15,29,44
42,26/05/2015,12,23,28,51
42,26/05/2015,13,38,33,71
42,26/05/2015,14,25,18,43
42,26/05/2015,15,34,35,69
42,26/05/2015,16,62,35,97
42,26/05/2015,17,126,56,182
42,26/05/2015,18,83,51,134
42,26/05/2015,19,39,23,62
42,26/05/2015,20,46,29,75
42,26/05/2015,21,34,13,47
42,26/05/2015,22,13,6,19
42,26/05/2015,23,11,10,21
42,27/05/2015,0,3,1,4
42,27/05/2015,1,3,1,4
42,27/05/2015,2,1,0,1
42,27/05/2015,3,0,0,0
42,27/05/2015,4,1,1,2
42,27/05/2015,5,0,5,5
42,27/05/2015,6,8,15,23
42,27/05/2015,7,12,34,46
42,27/05/2015,8,38,124,162
42,27/05/2015,9,22,74,96
42,27/05/2015,10,16,32,48
42,27/05/2015,11,12,27,39
42,27/05/2015,12,13,34,47
42,27/05/2015,13,22,34,56
42,27/05/2015,14,32,25,57
42,27/05/2015,15,25,30,55
42,27/05/2015,16,42,25,67
42,27/05/2015,17,85,49,134
42,27/05/2015,18,56,35,91
42,27/05/2015,19,37,27,64
42,27/05/2015,20,29,15,44
42,27/05/2015,21,15,2,17
42,27/05/2015,22,11,7,18
42,27/05/2015,23,11,5,16
42,28/05/2015,0,1,0,1
42,28/05/2015,1,1,0,1
42,28/05/2015,2,2,0,2
42,28/05/2015,3,0,0,0
42,28/05/2015,4,0,1,1
42,28/05/2015,5,1,4,5
42,28/05/2015,6,3,13,16
42,28/05/2015,7,14,46,60
42,28/05/2015,8,36,111,147
42,28/05/2015,9,22,75,97
42,28/05/2015,10,13,32,45
42,28/05/2015,11,13,19,32
42,28/05/2015,12,15,21,36
42,28/05/2015,13,10,15,25
42,28/05/2015,14,25,22,47
42,28/05/2015,15,33,22,55
42,28/05/2015,16,58,27,85
42,28/05/2015,17,76,44,120
42,28/05/2015,18,58,43,101
42,28/05/2015,19,41,19,60
42,28/05/2015,20,41,12,53
42,28/05/2015,21,13,12,25
42,28/05/2015,22,10,9,19
42,28/05/2015,23,4,5,9
42,29/05/2015,0,8,5,13
42,29/05/2015,1,1,1,2
42,29/05/2015,2,0,1,1
42,29/05/2015,3,0,1,1
42,29/05/2015,4,1,0,1
42,29/05/2015,5,1,3,4
42,29/05/2015,6,4,9,13
42,29/05/2015,7,11,41,52
42,29/05/2015,8,32,72,104
42,29/05/2015,9,16,63,79
42,29/05/2015,10,19,31,50
42,29/05/2015,11,19,21,40
42,29/05/2015,12,28,26,54
42,29/05/2015,13,15,24,39
42,29/05/2015,14,11,18,29
42,29/05/2015,15,29,28,57
42,29/05/2015,16,35,29,64
42,29/05/2015,17,66,44,110
42,29/05/2015,18,51,28,79
42,29/05/2015,19,42,54,96
42,29/05/2015,20,22,14,36
42,29/05/2015,21,12,12,24
42,29/05/2015,22,10,7,17
42,29/05/2015,23,14,7,21
42,30/05/2015,0,5,3,8
42,30/05/2015,1,3,4,7
42,30/05/2015,2,3,0,3
42,30/05/2015,3,2,0,2
42,30/05/2015,4,0,1,1
42,30/05/2015,5,0,3,3
42,30/05/2015,6,1,7,8
42,30/05/2015,7,2,3,5
42,30/05/2015,8,4,15,19
42,30/05/2015,9,17,20,37
42,30/05/2015,10,25,33,58
42,30/05/2015,11,28,29,57
42,30/05/2015,12,20,31,51
42,30/05/2015,13,19,24,43
42,30/05/2015,14,20,29,49
42,30/05/2015,15,37,43,80
42,30/05/2015,16,41,32,73
42,30/05/2015,17,46,24,70
42,30/05/2015,18,34,26,60
42,30/05/2015,19,14,14,28
42,30/05/2015,20,13,11,24
42,30/05/2015,21,8,12,20
42,30/05/2015,22,12,10,22
42,30/05/2015,23,13,9,22
42,31/05/2015,0,6,4,10
42,31/05/2015,1,0,0,0
42,31/05/2015,2,1,3,4
42,31/05/2015,3,3,0,3
42,31/05/2015,4,2,0,2
42,31/05/2015,5,0,1,1
42,31/05/2015,6,1,3,4
42,31/05/2015,7,1,2,3
42,31/05/2015,8,1,5,6
42,31/05/2015,9,4,17,21
42,31/05/2015,10,8,20,28
42,31/05/2015,11,8,24,32
42,31/05/2015,12,14,13,27
42,31/05/2015,13,13,18,31
42,31/05/2015,14,23,18,41
42,31/05/2015,15,26,28,54
42,31/05/2015,16,16,18,34
42,31/05/2015,17,34,12,46
42,31/05/2015,18,13,11,24
42,31/05/2015,19,10,11,21
42,31/05/2015,20,14,12,26
42,31/05/2015,21,7,7,14
42,31/05/2015,22,5,5,10
42,31/05/2015,23,5,5,10
42,01/06/2015,0,3,2,5
42,01/06/2015,1,0,2,2
42,01/06/2015,2,1,0,1
42,01/06/2015,3,0,0,0
42,01/06/2015,4,0,1,1
42,01/06/2015,5,2,3,5
42,01/06/2015,6,2,16,18
42,01/06/2015,7,15,38,53
42,01/06/2015,8,30,111,141
42,01/06/2015,9,16,74,90
42,01/06/2015,10,12,30,42
42,01/06/2015,11,10,18,28
42,01/06/2015,12,18,18,36
42,01/06/2015,13,17,29,46
42,01/06/2015,14,18,23,41
42,01/06/2015,15,35,15,50
42,01/06/2015,16,40,29,69
42,01/06/2015,17,87,34,121
42,01/06/2015,18,46,25,71
42,01/06/2015,19,24,17,41
42,01/06/2015,20,19,3,22
42,01/06/2015,21,15,4,19
42,01/06/2015,22,6,9,15
42,01/06/2015,23,3,5,8
42,02/06/2015,0,4,3,7
42,02/06/2015,1,1,3,4
42,02/06/2015,2,0,0,0
42,02/06/2015,3,0,0,0
42,02/06/2015,4,0,0,0
42,02/06/2015,5,0,3,3
42,02/06/2015,6,7,11,18
42,02/06/2015,7,12,20,32
42,02/06/2015,8,23,81,104
42,02/06/2015,9,21,57,78
42,02/06/2015,10,2,22,24
42,02/06/2015,11,7,22,29
42,02/06/2015,12,12,15,27
42,02/06/2015,13,15,19,34
42,02/06/2015,14,19,19,38
42,02/06/2015,15,20,23,43
42,02/06/2015,16,40,24,64
42,02/06/2015,17,77,45,122
42,02/06/2015,18,52,35,87
42,02/06/2015,19,25,24,49
42,02/06/2015,20,37,14,51
42,02/06/2015,21,17,15,32
42,02/06/2015,22,8,5,13
42,02/06/2015,23,11,4,15
42,03/06/2015,0,2,2,4
42,03/06/2015,1,3,0,3
42,03/06/2015,2,0,0,0
42,03/06/2015,3,1,1,2
42,03/06/2015,4,0,1,1
42,03/06/2015,5,3,3,6
42,03/06/2015,6,5,14,19
42,03/06/2015,7,14,40,54
42,03/06/2015,8,33,121,154
42,03/06/2015,9,18,70,88
42,03/06/2015,10,18,29,47
42,03/06/2015,11,16,23,39
42,03/06/2015,12,18,26,44
42,03/06/2015,13,19,28,47
42,03/06/2015,14,34,32,66
42,03/06/2015,15,27,24,51
42,03/06/2015,16,54,35,89
42,03/06/2015,17,94,63,157
42,03/06/2015,18,69,40,109
42,03/06/2015,19,35,29,64
42,03/06/2015,20,33,13,46
42,03/06/2015,21,27,18,45
42,03/06/2015,22,12,7,19
42,03/06/2015,23,5,5,10
42,04/06/2015,0,2,1,3
42,04/06/2015,1,1,1,2
42,04/06/2015,2,1,0,1
42,04/06/2015,3,0,0,0
42,04/06/2015,4,0,2,2
42,04/06/2015,5,1,2,3
42,04/06/2015,6,7,12,19
42,04/06/2015,7,19,46,65
42,04/06/2015,8,31,119,150
42,04/06/2015,9,21,78,99
42,04/06/2015,10,14,22,36
42,04/06/2015,11,11,13,24
42,04/06/2015,12,21,18,39
42,04/06/2015,13,16,22,38
42,04/06/2015,14,29,28,57
42,04/06/2015,15,34,26,60
42,04/06/2015,16,71,33,104
42,04/06/2015,17,104,51,155
42,04/06/2015,18,72,50,122
42,04/06/2015,19,50,30,80
42,04/06/2015,20,41,24,65
42,04/06/2015,21,23,14,37
42,04/06/2015,22,12,11,23
42,04/06/2015,23,10,8,18
42,05/06/2015,0,5,4,9
42,05/06/2015,1,1,1,2
42,05/06/2015,2,0,1,1
42,05/06/2015,3,1,1,2
42,05/06/2015,4,0,1,1
42,05/06/2015,5,1,4,5
42,05/06/2015,6,7,10,17
42,05/06/2015,7,13,39,52
42,05/06/2015,8,22,90,112
42,05/06/2015,9,16,72,88
42,05/06/2015,10,15,35,50
42,05/06/2015,11,17,23,40
42,05/06/2015,12,30,21,51
42,05/06/2015,13,16,22,38
42,05/06/2015,14,25,27,52
42,05/06/2015,15,29,23,52
42,05/06/2015,16,41,40,81
42,05/06/2015,17,75,44,119
42,05/06/2015,18,46,40,86
42,05/06/2015,19,29,14,43
42,05/06/2015,20,15,17,32
42,05/06/2015,21,18,7,25
42,05/06/2015,22,10,8,18
42,05/06/2015,23,10,10,20
42,06/06/2015,0,4,4,8
42,06/06/2015,1,4,1,5
42,06/06/2015,2,1,1,2
42,06/06/2015,3,2,1,3
42,06/06/2015,4,1,2,3
42,06/06/2015,5,2,1,3
42,06/06/2015,6,4,4,8
42,06/06/2015,7,3,4,7
42,06/06/2015,8,2,13,15
42,06/06/2015,9,9,10,19
42,06/06/2015,10,9,18,27
42,06/06/2015,11,10,16,26
42,06/06/2015,12,12,14,26
42,06/06/2015,13,16,14,30
42,06/06/2015,14,9,23,32
42,06/06/2015,15,17,29,46
42,06/06/2015,16,22,13,35
42,06/06/2015,17,29,23,52
42,06/06/2015,18,17,11,28
42,06/06/2015,19,17,16,33
42,06/06/2015,20,7,5,12
42,06/06/2015,21,6,6,12
42,06/06/2015,22,10,2,12
42,06/06/2015,23,7,4,11
42,07/06/2015,0,5,5,10
42,07/06/2015,1,1,1,2
42,07/06/2015,2,2,0,2
42,07/06/2015,3,4,1,5
42,07/06/2015,4,0,2,2
42,07/06/2015,5,2,0,2
42,07/06/2015,6,0,2,2
42,07/06/2015,7,4,6,10
42,07/06/2015,8,4,8,12
42,07/06/2015,9,16,15,31
42,07/06/2015,10,17,39,56
42,07/06/2015,11,15,36,51
42,07/06/2015,12,38,56,94
42,07/06/2015,13,31,43,74
42,07/06/2015,14,32,56,88
42,07/06/2015,15,35,48,83
42,07/06/2015,16,39,44,83
42,07/06/2015,17,53,33,86
42,07/06/2015,18,35,29,64
42,07/06/2015,19,35,19,54
42,07/06/2015,20,23,10,33
42,07/06/2015,21,12,10,22
42,07/06/2015,22,13,4,17
42,07/06/2015,23,5,4,9
42,08/06/2015,0,6,3,9
42,08/06/2015,1,1,0,1
42,08/06/2015,2,0,0,0
42,08/06/2015,3,0,0,0
42,08/06/2015,4,1,0,1
42,08/06/2015,5,0,5,5
42,08/06/2015,6,4,9,13
42,08/06/2015,7,12,48,60
42,08/06/2015,8,35,106,141
42,08/06/2015,9,23,79,102
42,08/06/2015,10,21,37,58
42,08/06/2015,11,13,25,38
42,08/06/2015,12,15,32,47
42,08/06/2015,13,21,26,47
42,08/06/2015,14,52,31,83
42,08/06/2015,15,43,30,73
42,08/06/2015,16,64,48,112
42,08/06/2015,17,96,53,149
42,08/06/2015,18,77,35,112
42,08/06/2015,19,40,39,79
42,08/06/2015,20,35,17,52
42,08/06/2015,21,31,14,45
42,08/06/2015,22,15,12,27
42,08/06/2015,23,10,3,13
42,09/06/2015,0,5,2,7
42,09/06/2015,1,2,2,4
42,09/06/2015,2,0,0,0
42,09/06/2015,3,0,0,0
42,09/06/2015,4,0,1,1
42,09/06/2015,5,1,7,8
42,09/06/2015,6,4,12,16
42,09/06/2015,7,14,49,63
42,09/06/2015,8,33,110,143
42,09/06/2015,9,24,84,108
42,09/06/2015,10,21,27,48
42,09/06/2015,11,17,16,33
42,09/06/2015,12,26,32,58
42,09/06/2015,13,24,25,49
42,09/06/2015,14,40,38,78
42,09/06/2015,15,45,37,82
42,09/06/2015,16,54,50,104
42,09/06/2015,17,101,76,177
42,09/06/2015,18,90,56,146
42,09/06/2015,19,34,25,59
42,09/06/2015,20,52,38,90
42,09/06/2015,21,34,16,50
42,09/06/2015,22,19,7,26
42,09/06/2015,23,18,10,28
42,10/06/2015,0,7,2,9
42,10/06/2015,1,1,2,3
42,10/06/2015,2,1,1,2
42,10/06/2015,3,0,0,0
42,10/06/2015,4,0,2,2
42,10/06/2015,5,2,3,5
42,10/06/2015,6,8,17,25
42,10/06/2015,7,15,54,69
42,10/06/2015,8,38,114,152
42,10/06/2015,9,19,69,88
42,10/06/2015,10,17,42,59
42,10/06/2015,11,21,33,54
42,10/06/2015,12,34,31,65
42,10/06/2015,13,48,29,77
42,10/06/2015,14,35,25,60
42,10/06/2015,15,40,31,71
42,10/06/2015,16,60,54,114
42,10/06/2015,17,112,84,196
42,10/06/2015,18,77,70,147
42,10/06/2015,19,49,45,94
42,10/06/2015,20,40,28,68
42,10/06/2015,21,50,19,69
42,10/06/2015,22,33,13,46
42,10/06/2015,23,7,4,11
42,11/06/2015,0,2,3,5
42,11/06/2015,1,3,2,5
42,11/06/2015,2,0,0,0
42,11/06/2015,3,0,0,0
42,11/06/2015,4,1,1,2
42,11/06/2015,5,0,3,3
42,11/06/2015,6,5,12,17
42,11/06/2015,7,17,50,67
42,11/06/2015,8,44,119,163
42,11/06/2015,9,22,70,92
42,11/06/2015,10,11,46,57
42,11/06/2015,11,23,33,56
42,11/06/2015,12,33,42,75
42,11/06/2015,13,35,36,71
42,11/06/2015,14,61,36,97
42,11/06/2015,15,51,30,81
42,11/06/2015,16,59,51,110
42,11/06/2015,17,116,83,199
42,11/06/2015,18,79,95,174
42,11/06/2015,19,57,34,91
42,11/06/2015,20,52,22,74
42,11/06/2015,21,47,20,67
42,11/06/2015,22,37,12,49
42,11/06/2015,23,12,8,20
42,12/06/2015,0,4,5,9
42,12/06/2015,1,2,4,6
42,12/06/2015,2,0,0,0
42,12/06/2015,3,0,0,0
42,12/06/2015,4,0,1,1
42,12/06/2015,5,1,4,5
42,12/06/2015,6,6,15,21
42,12/06/2015,7,8,46,54
42,12/06/2015,8,38,99,137
42,12/06/2015,9,19,75,94
42,12/06/2015,10,9,38,47
42,12/06/2015,11,22,31,53
42,12/06/2015,12,31,21,52
42,12/06/2015,13,18,37,55
42,12/06/2015,14,29,26,55
42,12/06/2015,15,42,21,63
42,12/06/2015,16,41,50,91
42,12/06/2015,17,82,61,143
42,12/06/2015,18,45,32,77
42,12/06/2015,19,27,28,55
42,12/06/2015,20,28,17,45
42,12/06/2015,21,25,13,38
42,12/06/2015,22,10,10,20
42,12/06/2015,23,9,5,14
42,13/06/2015,0,9,5,14
42,13/06/2015,1,2,2,4
42,13/06/2015,2,0,0,0
42,13/06/2015,3,1,0,1
42,13/06/2015,4,0,1,1
42,13/06/2015,5,0,1,1
42,13/06/2015,6,2,5,7
42,13/06/2015,7,2,7,9
42,13/06/2015,8,13,14,27
42,13/06/2015,9,11,23,34
42,13/06/2015,10,15,37,52
42,13/06/2015,11,14,18,32
42,13/06/2015,12,26,25,51
42,13/06/2015,13,20,42,62
42,13/06/2015,14,18,36,54
42,13/06/2015,15,25,15,40
42,13/06/2015,16,39,19,58
42,13/06/2015,17,15,18,33
42,13/06/2015,18,8,13,21
42,13/06/2015,19,10,9,19
42,13/06/2015,20,11,21,32
42,13/06/2015,21,8,5,13
42,13/06/2015,22,15,4,19
42,13/06/2015,23,8,9,17
42,14/06/2015,0,5,8,13
42,14/06/2015,1,1,3,4
42,14/06/2015,2,1,0,1
42,14/06/2015,3,0,2,2
42,14/06/2015,4,0,0,0
42,14/06/2015,5,2,1,3
42,14/06/2015,6,2,3,5
42,14/06/2015,7,2,4,6
42,14/06/2015,8,3,7,10
42,14/06/2015,9,10,15,25
42,14/06/2015,10,9,21,30
42,14/06/2015,11,19,22,41
42,14/06/2015,12,15,20,35
42,14/06/2015,13,20,22,42
42,14/06/2015,14,29,30,59
42,14/06/2015,15,23,31,54
42,14/06/2015,16,23,23,46
42,14/06/2015,17,41,25,66
42,14/06/2015,18,25,30,55
42,14/06/2015,19,26,10,36
42,14/06/2015,20,21,7,28
42,14/06/2015,21,19,18,37
42,14/06/2015,22,11,5,16
42,14/06/2015,23,2,4,6
42,15/06/2015,0,2,3,5
42,15/06/2015,1,1,1,2
42,15/06/2015,2,0,0,0
42,15/06/2015,3,1,1,2
42,15/06/2015,4,0,1,1
42,15/06/2015,5,1,4,5
42,15/06/2015,6,6,10,16
42,15/06/2015,7,14,41,55
42,15/06/2015,8,47,122,169
42,15/06/2015,9,17,73,90
42,15/06/2015,10,9,28,37
42,15/06/2015,11,14,20,34
42,15/06/2015,12,7,28,35
42,15/06/2015,13,29,32,61
42,15/06/2015,14,35,26,61
42,15/06/2015,15,29,20,49
42,15/06/2015,16,56,49,105
42,15/06/2015,17,102,62,164
42,15/06/2015,18,75,56,131
42,15/06/2015,19,22,37,59
42,15/06/2015,20,33,23,56
42,15/06/2015,21,28,8,36
42,15/06/2015,22,17,5,22
42,15/06/2015,23,6,6,12
42,16/06/2015,0,2,1,3
42,16/06/2015,1,0,2,2
42,16/06/2015,2,2,1,3
42,16/06/2015,3,0,0,0
42,16/06/2015,4,0,0,0
42,16/06/2015,5,3,5,8
42,16/06/2015,6,3,9,12
42,16/06/2015,7,18,46,64
42,16/06/2015,8,44,105,149
42,16/06/2015,9,19,71,90
42,16/06/2015,10,25,27,52
42,16/06/2015,11,13,28,41
42,16/06/2015,12,28,21,49
42,16/06/2015,13,24,23,47
42,16/06/2015,14,28,18,46
42,16/06/2015,15,25,30,55
42,16/06/2015,16,60,44,104
42,16/06/2015,17,105,56,161
42,16/06/2015,18,76,42,118
42,16/06/2015,19,41,34,75
42,16/06/2015,20,40,19,59
42,16/06/2015,21,18,13,31
42,16/06/2015,22,11,9,20
42,16/06/2015,23,4,6,10
42,17/06/2015,0,5,2,7
42,17/06/2015,1,0,1,1
42,17/06/2015,2,2,0,2
42,17/06/2015,3,0,0,0
42,17/06/2015,4,0,1,1
42,17/06/2015,5,1,7,8
42,17/06/2015,6,5,10,15
42,17/06/2015,7,13,49,62
42,17/06/2015,8,40,92,132
42,17/06/2015,9,33,83,116
42,17/06/2015,10,9,33,42
42,17/06/2015,11,22,20,42
42,17/06/2015,12,22,30,52
42,17/06/2015,13,33,38,71
42,17/06/2015,14,30,26,56
42,17/06/2015,15,48,25,73
42,17/06/2015,16,60,38,98
42,17/06/2015,17,92,52,144
42,17/06/2015,18,72,46,118
42,17/06/2015,19,36,21,57
42,17/06/2015,20,20,20,40
42,17/06/2015,21,15,14,29
42,17/06/2015,22,18,4,22
42,17/06/2015,23,16,5,21
42,18/06/2015,0,3,2,5
42,18/06/2015,1,2,2,4
42,18/06/2015,2,1,0,1
42,18/06/2015,3,2,0,2
42,18/06/2015,4,1,1,2
42,18/06/2015,5,2,8,10
42,18/06/2015,6,3,13,16
42,18/06/2015,7,16,42,58
42,18/06/2015,8,34,122,156
42,18/06/2015,9,28,76,104
42,18/06/2015,10,9,22,31
42,18/06/2015,11,9,17,26
42,18/06/2015,12,20,34,54
42,18/06/2015,13,23,19,42
42,18/06/2015,14,32,26,58
42,18/06/2015,15,20,20,40
42,18/06/2015,16,63,40,103
42,18/06/2015,17,72,65,137
42,18/06/2015,18,79,30,109
42,18/06/2015,19,34,20,54
42,18/06/2015,20,24,19,43
42,18/06/2015,21,18,16,34
42,18/06/2015,22,17,5,22
42,18/06/2015,23,9,4,13
42,19/06/2015,0,9,3,12
42,19/06/2015,1,5,0,5
42,19/06/2015,2,0,2,2
42,19/06/2015,3,0,0,0
42,19/06/2015,4,0,1,1
42,19/06/2015,5,1,5,6
42,19/06/2015,6,8,12,20
42,19/06/2015,7,13,40,53
42,19/06/2015,8,37,82,119
42,19/06/2015,9,24,69,93
42,19/06/2015,10,11,40,51
42,19/06/2015,11,14,19,33
42,19/06/2015,12,26,27,53
42,19/06/2015,13,15,20,35
42,19/06/2015,14,19,36,55
42,19/06/2015,15,29,32,61
42,19/06/2015,16,62,40,102
42,19/06/2015,17,84,48,132
42,19/06/2015,18,47,42,89
42,19/06/2015,19,21,20,41
42,19/06/2015,20,21,11,32
42,19/06/2015,21,9,12,21
42,19/06/2015,22,8,11,19
42,19/06/2015,23,9,9,18
42,20/06/2015,0,4,8,12
42,20/06/2015,1,5,0,5
42,20/06/2015,2,4,2,6
42,20/06/2015,3,3,0,3
42,20/06/2015,4,0,0,0
42,20/06/2015,5,1,2,3
42,20/06/2015,6,3,4,7
42,20/06/2015,7,4,7,11
42,20/06/2015,8,6,18,24
42,20/06/2015,9,12,16,28
42,20/06/2015,10,15,24,39
42,20/06/2015,11,19,34,53
42,20/06/2015,12,33,38,71
42,20/06/2015,13,52,53,105
42,20/06/2015,14,41,46,87
42,20/06/2015,15,56,52,108
42,20/06/2015,16,46,36,82
42,20/06/2015,17,39,47,86
42,20/06/2015,18,28,18,46
42,20/06/2015,19,19,17,36
42,20/06/2015,20,28,27,55
42,20/06/2015,21,15,10,25
42,20/06/2015,22,4,14,18
42,20/06/2015,23,7,10,17
42,21/06/2015,0,9,2,11
42,21/06/2015,1,4,3,7
42,21/06/2015,2,1,1,2
42,21/06/2015,3,4,1,5
42,21/06/2015,4,1,1,2
42,21/06/2015,5,3,3,6
42,21/06/2015,6,2,4,6
42,21/06/2015,7,3,4,7
42,21/06/2015,8,5,7,12
42,21/06/2015,9,7,17,24
42,21/06/2015,10,10,15,25
42,21/06/2015,11,10,28,38
42,21/06/2015,12,19,17,36
42,21/06/2015,13,18,33,51
42,21/06/2015,14,14,16,30
42,21/06/2015,15,20,15,35
42,21/06/2015,16,21,17,38
42,21/06/2015,17,24,13,37
42,21/06/2015,18,23,27,50
42,21/06/2015,19,19,21,40
42,21/06/2015,20,20,18,38
42,21/06/2015,21,18,10,28
42,21/06/2015,22,15,11,26
42,21/06/2015,23,5,5,10
42,22/06/2015,0,8,5,13
42,22/06/2015,1,2,1,3
42,22/06/2015,2,1,0,1
42,22/06/2015,3,1,0,1
42,22/06/2015,4,0,0,0
42,22/06/2015,5,1,3,4
42,22/06/2015,6,4,13,17
42,22/06/2015,7,21,48,69
42,22/06/2015,8,25,93,118
42,22/06/2015,9,20,79,99
42,22/06/2015,10,14,31,45
42,22/06/2015,11,13,14,27
42,22/06/2015,12,9,21,30
42,22/06/2015,13,13,14,27
42,22/06/2015,14,24,22,46
42,22/06/2015,15,25,18,43
42,22/06/2015,16,47,25,72
42,22/06/2015,17,97,60,157
42,22/06/2015,18,48,35,83
42,22/06/2015,19,41,21,62
42,22/06/2015,20,40,9,49
42,22/06/2015,21,18,12,30
42,22/06/2015,22,3,12,15
42,22/06/2015,23,7,10,17
42,23/06/2015,0,4,3,7
42,23/06/2015,1,1,3,4
42,23/06/2015,2,1,0,1
42,23/06/2015,3,3,0,3
42,23/06/2015,4,0,0,0
42,23/06/2015,5,2,4,6
42,23/06/2015,6,9,14,23
42,23/06/2015,7,17,45,62
42,23/06/2015,8,37,110,147
42,23/06/2015,9,23,72,95
42,23/06/2015,10,10,30,40
42,23/06/2015,11,17,23,40
42,23/06/2015,12,26,33,59
42,23/06/2015,13,28,31,59
42,23/06/2015,14,33,28,61
42,23/06/2015,15,48,31,79
42,23/06/2015,16,56,50,106
42,23/06/2015,17,121,77,198
42,23/06/2015,18,70,53,123
42,23/06/2015,19,47,25,72
42,23/06/2015,20,49,24,73
42,23/06/2015,21,22,15,37
42,23/06/2015,22,23,14,37
42,23/06/2015,23,7,10,17
42,24/06/2015,0,10,4,14
42,24/06/2015,1,2,1,3
42,24/06/2015,2,1,1,2
42,24/06/2015,3,0,0,0
42,24/06/2015,4,0,1,1
42,24/06/2015,5,0,5,5
42,24/06/2015,6,6,15,21
42,24/06/2015,7,19,44,63
42,24/06/2015,8,47,104,151
42,24/06/2015,9,7,73,80
42,24/06/2015,10,11,30,41
42,24/06/2015,11,14,26,40
42,24/06/2015,12,21,23,44
42,24/06/2015,13,25,29,54
42,24/06/2015,14,27,19,46
42,24/06/2015,15,32,24,56
42,24/06/2015,16,53,25,78
42,24/06/2015,17,94,61,155
42,24/06/2015,18,48,35,83
42,24/06/2015,19,44,26,70
42,24/06/2015,20,40,12,52
42,24/06/2015,21,21,10,31
42,24/06/2015,22,15,15,30
42,24/06/2015,23,5,12,17
42,25/06/2015,0,6,3,9
42,25/06/2015,1,0,3,3
42,25/06/2015,2,2,1,3
42,25/06/2015,3,0,1,1
42,25/06/2015,4,0,1,1
42,25/06/2015,5,0,4,4
42,25/06/2015,6,4,14,18
42,25/06/2015,7,14,49,63
42,25/06/2015,8,46,107,153
42,25/06/2015,9,19,70,89
42,25/06/2015,10,15,37,52
42,25/06/2015,11,13,23,36
42,25/06/2015,12,17,23,40
42,25/06/2015,13,17,17,34
42,25/06/2015,14,28,20,48
42,25/06/2015,15,27,22,49
42,25/06/2015,16,29,37,66
42,25/06/2015,17,72,52,124
42,25/06/2015,18,59,43,102
42,25/06/2015,19,34,16,50
42,25/06/2015,20,26,14,40
42,25/06/2015,21,9,21,30
42,25/06/2015,22,12,15,27
42,25/06/2015,23,9,3,12
42,26/06/2015,0,2,1,3
42,26/06/2015,1,1,3,4
42,26/06/2015,2,1,0,1
42,26/06/2015,3,0,1,1
42,26/06/2015,4,0,0,0
42,26/06/2015,5,0,3,3
42,26/06/2015,6,8,14,22
42,26/06/2015,7,14,31,45
42,26/06/2015,8,24,68,92
42,26/06/2015,9,17,69,86
42,26/06/2015,10,8,38,46
42,26/06/2015,11,16,16,32
42,26/06/2015,12,20,30,50
42,26/06/2015,13,26,24,50
42,26/06/2015,14,20,23,43
42,26/06/2015,15,29,27,56
42,26/06/2015,16,36,24,60
42,26/06/2015,17,83,42,125
42,26/06/2015,18,36,28,64
42,26/06/2015,19,32,29,61
42,26/06/2015,20,14,25,39
42,26/06/2015,21,22,13,35
42,26/06/2015,22,15,13,28
42,26/06/2015,23,8,8,16
42,27/06/2015,0,9,2,11
42,27/06/2015,1,6,8,14
42,27/06/2015,2,3,1,4
42,27/06/2015,3,1,1,2
42,27/06/2015,4,0,1,1
42,27/06/2015,5,1,2,3
42,27/06/2015,6,1,1,2
42,27/06/2015,7,4,9,13
42,27/06/2015,8,1,14,15
42,27/06/2015,9,16,21,37
42,27/06/2015,10,19,18,37
42,27/06/2015,11,41,40,81
42,27/06/2015,12,33,36,69
42,27/06/2015,13,58,58,116
42,27/06/2015,14,38,45,83
42,27/06/2015,15,48,64,112
42,27/06/2015,16,68,54,122
42,27/06/2015,17,58,43,101
42,27/06/2015,18,20,29,49
42,27/06/2015,19,20,26,46
42,27/06/2015,20,16,23,39
42,27/06/2015,21,15,16,31
42,27/06/2015,22,21,10,31
42,27/06/2015,23,9,5,14
42,28/06/2015,0,7,1,8
42,28/06/2015,1,4,2,6
42,28/06/2015,2,1,3,4
42,28/06/2015,3,0,1,1
42,28/06/2015,4,0,1,1
42,28/06/2015,5,0,0,0
42,28/06/2015,6,1,0,1
42,28/06/2015,7,3,6,9
42,28/06/2015,8,3,4,7
42,28/06/2015,9,5,16,21
42,28/06/2015,10,6,27,33
42,28/06/2015,11,16,16,32
42,28/06/2015,12,7,20,27
42,28/06/2015,13,27,21,48
42,28/06/2015,14,25,38,63
42,28/06/2015,15,30,27,57
42,28/06/2015,16,26,29,55
42,28/06/2015,17,25,23,48
42,28/06/2015,18,24,23,47
42,28/06/2015,19,16,11,27
42,28/06/2015,20,17,20,37
42,28/06/2015,21,11,11,22
42,28/06/2015,22,16,8,24
42,28/06/2015,23,7,11,18
42,29/06/2015,0,1,5,6
42,29/06/2015,1,2,1,3
42,29/06/2015,2,2,0,2
42,29/06/2015,3,0,0,0
42,29/06/2015,4,1,0,1
42,29/06/2015,5,2,2,4
42,29/06/2015,6,6,12,18
42,29/06/2015,7,18,33,51
42,29/06/2015,8,46,86,132
42,29/06/2015,9,17,67,84
42,29/06/2015,10,11,29,40
42,29/06/2015,11,14,30,44
42,29/06/2015,12,21,24,45
42,29/06/2015,13,21,19,40
42,29/06/2015,14,23,27,50
42,29/06/2015,15,29,33,62
42,29/06/2015,16,50,39,89
42,29/06/2015,17,98,52,150
42,29/06/2015,18,58,30,88
42,29/06/2015,19,27,26,53
42,29/06/2015,20,26,12,38
42,29/06/2015,21,22,12,34
42,29/06/2015,22,11,8,19
42,29/06/2015,23,5,9,14
42,30/06/2015,0,4,3,7
42,30/06/2015,1,0,0,0
42,30/06/2015,2,0,0,0
42,30/06/2015,3,3,1,4
42,30/06/2015,4,0,3,3
42,30/06/2015,5,1,1,2
42,30/06/2015,6,5,7,12
42,30/06/2015,7,19,45,64
42,30/06/2015,8,37,104,141
42,30/06/2015,9,22,75,97
42,30/06/2015,10,16,26,42
42,30/06/2015,11,17,32,49
42,30/06/2015,12,27,30,57
42,30/06/2015,13,32,25,57
42,30/06/2015,14,24,24,48
42,30/06/2015,15,24,27,51
42,30/06/2015,16,45,43,88
42,30/06/2015,17,98,68,166
42,30/06/2015,18,55,52,107
42,30/06/2015,19,48,31,79
42,30/06/2015,20,47,25,72
42,30/06/2015,21,30,23,53
42,30/06/2015,22,16,11,27
42,30/06/2015,23,15,12,27
42,01/07/2015,0,10,4,14
42,01/07/2015,1,3,2,5
42,01/07/2015,2,0,1,1
42,01/07/2015,3,0,0,0
42,01/07/2015,4,0,0,0
42,01/07/2015,5,3,5,8
42,01/07/2015,6,7,10,17
42,01/07/2015,7,10,51,61
42,01/07/2015,8,42,112,154
42,01/07/2015,9,20,75,95
42,01/07/2015,10,8,27,35
42,01/07/2015,11,21,24,45
42,01/07/2015,12,20,35,55
42,01/07/2015,13,27,34,61
42,01/07/2015,14,31,32,63
42,01/07/2015,15,38,26,64
42,01/07/2015,16,52,37,89
42,01/07/2015,17,96,74,170
42,01/07/2015,18,53,38,91
42,01/07/2015,19,31,18,49
42,01/07/2015,20,30,16,46
42,01/07/2015,21,31,12,43
42,01/07/2015,22,10,14,24
42,01/07/2015,23,12,4,16
42,02/07/2015,0,5,6,11
42,02/07/2015,1,7,0,7
42,02/07/2015,2,3,2,5
42,02/07/2015,3,0,0,0
42,02/07/2015,4,1,0,1
42,02/07/2015,5,1,3,4
42,02/07/2015,6,5,6,11
42,02/07/2015,7,17,55,72
42,02/07/2015,8,40,89,129
42,02/07/2015,9,13,86,99
42,02/07/2015,10,14,23,37
42,02/07/2015,11,21,23,44
42,02/07/2015,12,33,24,57
42,02/07/2015,13,21,33,54
42,02/07/2015,14,23,35,58
42,02/07/2015,15,28,28,56
42,02/07/2015,16,56,36,92
42,02/07/2015,17,91,58,149
42,02/07/2015,18,53,56,109
42,02/07/2015,19,38,19,57
42,02/07/2015,20,29,17,46
42,02/07/2015,21,22,14,36
42,02/07/2015,22,15,16,31
42,02/07/2015,23,8,6,14
42,03/07/2015,0,10,5,15
42,03/07/2015,1,4,1,5
42,03/07/2015,2,7,1,8
42,03/07/2015,3,1,1,2
42,03/07/2015,4,1,1,2
42,03/07/2015,5,1,3,4
42,03/07/2015,6,4,8,12
42,03/07/2015,7,13,33,46
42,03/07/2015,8,40,82,122
42,03/07/2015,9,23,61,84
42,03/07/2015,10,16,33,49
42,03/07/2015,11,25,32,57
42,03/07/2015,12,25,24,49
42,03/07/2015,13,25,27,52
42,03/07/2015,14,30,29,59
42,03/07/2015,15,33,38,71
42,03/07/2015,16,65,56,121
42,03/07/2015,17,76,64,140
42,03/07/2015,18,51,37,88
42,03/07/2015,19,44,25,69
42,03/07/2015,20,34,17,51
42,03/07/2015,21,27,15,42
42,03/07/2015,22,14,15,29
42,03/07/2015,23,12,6,18
42,04/07/2015,0,11,6,17
42,04/07/2015,1,2,5,7
42,04/07/2015,2,2,0,2
42,04/07/2015,3,1,0,1
42,04/07/2015,4,0,2,2
42,04/07/2015,5,0,1,1
42,04/07/2015,6,2,3,5
42,04/07/2015,7,2,3,5
42,04/07/2015,8,0,4,4
42,04/07/2015,9,5,6,11
42,04/07/2015,10,3,9,12
42,04/07/2015,11,4,16,20
42,04/07/2015,12,19,14,33
42,04/07/2015,13,13,23,36
42,04/07/2015,14,19,22,41
42,04/07/2015,15,24,20,44
42,04/07/2015,16,30,23,53
42,04/07/2015,17,29,25,54
42,04/07/2015,18,23,24,47
42,04/07/2015,19,22,20,42
42,04/07/2015,20,14,19,33
42,04/07/2015,21,16,13,29
42,04/07/2015,22,12,7,19
42,04/07/2015,23,6,9,15
42,05/07/2015,0,5,6,11
42,05/07/2015,1,2,1,3
42,05/07/2015,2,4,2,6
42,05/07/2015,3,1,1,2
42,05/07/2015,4,2,0,2
42,05/07/2015,5,0,1,1
42,05/07/2015,6,4,3,7
42,05/07/2015,7,0,7,7
42,05/07/2015,8,6,8,14
42,05/07/2015,9,17,22,39
42,05/07/2015,10,26,64,90
42,05/07/2015,11,21,22,43
42,05/07/2015,12,19,23,42
42,05/07/2015,13,30,18,48
42,05/07/2015,14,10,18,28
42,05/07/2015,15,18,18,36
42,05/07/2015,16,21,19,40
42,05/07/2015,17,14,11,25
42,05/07/2015,18,18,12,30
42,05/07/2015,19,16,6,22
42,05/07/2015,20,14,13,27
42,05/07/2015,21,9,5,14
42,05/07/2015,22,3,4,7
42,05/07/2015,23,4,5,9
42,06/07/2015,0,1,2,3
42,06/07/2015,1,0,0,0
42,06/07/2015,2,0,0,0
42,06/07/2015,3,0,0,0
42,06/07/2015,4,0,0,0
42,06/07/2015,5,0,1,1
42,06/07/2015,6,4,11,15
42,06/07/2015,7,15,38,53
42,06/07/2015,8,25,96,121
42,06/07/2015,9,18,62,80
42,06/07/2015,10,30,30,60
42,06/07/2015,11,20,30,50
42,06/07/2015,12,19,25,44
42,06/07/2015,13,22,22,44
42,06/07/2015,14,25,16,41
42,06/07/2015,15,20,22,42
42,06/07/2015,16,60,36,96
42,06/07/2015,17,82,52,134
42,06/07/2015,18,56,29,85
42,06/07/2015,19,20,16,36
42,06/07/2015,20,16,14,30
42,06/07/2015,21,13,11,24
42,06/07/2015,22,7,8,15
42,06/07/2015,23,2,6,8
42,07/07/2015,0,2,5,7
42,07/07/2015,1,0,0,0
42,07/07/2015,2,0,0,0
42,07/07/2015,3,0,0,0
42,07/07/2015,4,0,0,0
42,07/07/2015,5,1,3,4
42,07/07/2015,6,5,15,20
42,07/07/2015,7,13,39,52
42,07/07/2015,8,38,83,121
42,07/07/2015,9,15,66,81
42,07/07/2015,10,11,36,47
42,07/07/2015,11,14,21,35
42,07/07/2015,12,20,21,41
42,07/07/2015,13,24,31,55
42,07/07/2015,14,27,14,41
42,07/07/2015,15,24,13,37
42,07/07/2015,16,32,23,55
42,07/07/2015,17,96,70,166
42,07/07/2015,18,74,35,109
42,07/07/2015,19,48,27,75
42,07/07/2015,20,34,15,49
42,07/07/2015,21,17,10,27
42,07/07/2015,22,12,10,22
42,07/07/2015,23,5,6,11
42,08/07/2015,0,0,1,1
42,08/07/2015,1,2,1,3
42,08/07/2015,2,0,0,0
42,08/07/2015,3,0,0,0
42,08/07/2015,4,1,1,2
42,08/07/2015,5,0,4,4
42,08/07/2015,6,4,10,14
42,08/07/2015,7,15,24,39
42,08/07/2015,8,25,69,94
42,08/07/2015,9,17,48,65
42,08/07/2015,10,8,27,35
42,08/07/2015,11,11,20,31
42,08/07/2015,12,21,21,42
42,08/07/2015,13,18,23,41
42,08/07/2015,14,13,19,32
42,08/07/2015,15,24,20,44
42,08/07/2015,16,29,29,58
42,08/07/2015,17,63,52,115
42,08/07/2015,18,57,21,78
42,08/07/2015,19,37,23,60
42,08/07/2015,20,33,28,61
42,08/07/2015,21,18,13,31
42,08/07/2015,22,18,4,22
42,08/07/2015,23,7,8,15
42,09/07/2015,0,7,2,9
42,09/07/2015,1,0,1,1
42,09/07/2015,2,1,1,2
42,09/07/2015,3,1,0,1
42,09/07/2015,4,0,0,0
42,09/07/2015,5,1,3,4
42,09/07/2015,6,5,13,18
42,09/07/2015,7,16,47,63
42,09/07/2015,8,38,98,136
42,09/07/2015,9,19,66,85
42,09/07/2015,10,21,31,52
42,09/07/2015,11,18,22,40
42,09/07/2015,12,22,30,52
42,09/07/2015,13,19,31,50
42,09/07/2015,14,20,18,38
42,09/07/2015,15,37,26,63
42,09/07/2015,16,58,25,83
42,09/07/2015,17,85,74,159
42,09/07/2015,18,58,33,91
42,09/07/2015,19,32,25,57
42,09/07/2015,20,30,16,46
42,09/07/2015,21,25,17,42
42,09/07/2015,22,15,10,25
42,09/07/2015,23,9,15,24
42,10/07/2015,0,4,2,6
42,10/07/2015,1,3,1,4
42,10/07/2015,2,1,0,1
42,10/07/2015,3,2,0,2
42,10/07/2015,4,0,0,0
42,10/07/2015,5,0,2,2
42,10/07/2015,6,4,10,14
42,10/07/2015,7,9,31,40
42,10/07/2015,8,25,73,98
42,10/07/2015,9,19,37,56
42,10/07/2015,10,14,33,47
42,10/07/2015,11,10,30,40
42,10/07/2015,12,19,14,33
42,10/07/2015,13,10,19,29
42,10/07/2015,14,13,17,30
42,10/07/2015,15,27,18,45
42,10/07/2015,16,39,23,62
42,10/07/2015,17,61,43,104
42,10/07/2015,18,39,31,70
42,10/07/2015,19,20,26,46
42,10/07/2015,20,15,20,35
42,10/07/2015,21,17,7,24
42,10/07/2015,22,7,8,15
42,10/07/2015,23,5,6,11
42,11/07/2015,0,5,3,8
42,11/07/2015,1,2,1,3
42,11/07/2015,2,3,0,3
42,11/07/2015,3,1,0,1
42,11/07/2015,4,0,0,0
42,11/07/2015,5,1,1,2
42,11/07/2015,6,0,0,0
42,11/07/2015,7,4,12,16
42,11/07/2015,8,2,11,13
42,11/07/2015,9,11,16,27
42,11/07/2015,10,23,31,54
42,11/07/2015,11,15,30,45
42,11/07/2015,12,20,29,49
42,11/07/2015,13,14,22,36
42,11/07/2015,14,18,29,47
42,11/07/2015,15,23,17,40
42,11/07/2015,16,26,20,46
42,11/07/2015,17,29,26,55
42,11/07/2015,18,21,21,42
42,11/07/2015,19,16,22,38
42,11/07/2015,20,14,9,23
42,11/07/2015,21,10,8,18
42,11/07/2015,22,10,11,21
42,11/07/2015,23,3,8,11
42,12/07/2015,0,3,3,6
42,12/07/2015,1,3,2,5
42,12/07/2015,2,1,1,2
42,12/07/2015,3,2,0,2
42,12/07/2015,4,3,1,4
42,12/07/2015,5,2,1,3
42,12/07/2015,6,1,1,2
42,12/07/2015,7,3,7,10
42,12/07/2015,8,7,9,16
42,12/07/2015,9,7,19,26
42,12/07/2015,10,11,21,32
42,12/07/2015,11,23,19,42
42,12/07/2015,12,19,22,41
42,12/07/2015,13,13,34,47
42,12/07/2015,14,17,19,36
42,12/07/2015,15,23,20,43
42,12/07/2015,16,30,16,46
42,12/07/2015,17,13,7,20
42,12/07/2015,18,20,11,31
42,12/07/2015,19,15,7,22
42,12/07/2015,20,22,10,32
42,12/07/2015,21,11,8,19
42,12/07/2015,22,9,5,14
42,12/07/2015,23,6,3,9
42,13/07/2015,0,0,2,2
42,13/07/2015,1,2,0,2
42,13/07/2015,2,1,1,2
42,13/07/2015,3,0,0,0
42,13/07/2015,4,2,0,2
42,13/07/2015,5,0,1,1
42,13/07/2015,6,5,12,17
42,13/07/2015,7,16,28,44
42,13/07/2015,8,29,86,115
42,13/07/2015,9,17,65,82
42,13/07/2015,10,13,35,48
42,13/07/2015,11,10,22,32
42,13/07/2015,12,18,32,50
42,13/07/2015,13,23,18,41
42,13/07/2015,14,18,13,31
42,13/07/2015,15,21,10,31
42,13/07/2015,16,32,32,64
42,13/07/2015,17,73,50,123
42,13/07/2015,18,49,31,80
42,13/07/2015,19,28,26,54
42,13/07/2015,20,38,29,67
42,13/07/2015,21,24,13,37
42,13/07/2015,22,12,4,16
42,13/07/2015,23,5,7,12
42,14/07/2015,0,1,3,4
42,14/07/2015,1,4,0,4
42,14/07/2015,2,1,1,2
42,14/07/2015,3,3,0,3
42,14/07/2015,4,0,0,0
42,14/07/2015,5,0,3,3
42,14/07/2015,6,2,17,19
42,14/07/2015,7,17,30,47
42,14/07/2015,8,49,99,148
42,14/07/2015,9,17,78,95
42,14/07/2015,10,16,31,47
42,14/07/2015,11,22,21,43
42,14/07/2015,12,18,23,41
42,14/07/2015,13,18,25,43
42,14/07/2015,14,16,19,35
42,14/07/2015,15,29,15,44
42,14/07/2015,16,50,45,95
42,14/07/2015,17,101,62,163
42,14/07/2015,18,57,45,102
42,14/07/2015,19,36,21,57
42,14/07/2015,20,40,23,63
42,14/07/2015,21,21,22,43
42,14/07/2015,22,6,6,12
42,14/07/2015,23,16,6,22
42,15/07/2015,0,2,3,5
42,15/07/2015,1,1,0,1
42,15/07/2015,2,0,0,0
42,15/07/2015,3,1,0,1
42,15/07/2015,4,0,0,0
42,15/07/2015,5,2,2,4
42,15/07/2015,6,5,13,18
42,15/07/2015,7,16,35,51
42,15/07/2015,8,44,94,138
42,15/07/2015,9,18,71,89
42,15/07/2015,10,14,31,45
42,15/07/2015,11,15,26,41
42,15/07/2015,12,20,25,45
42,15/07/2015,13,25,23,48
42,15/07/2015,14,30,28,58
42,15/07/2015,15,28,35,63
42,15/07/2015,16,49,31,80
42,15/07/2015,17,88,72,160
42,15/07/2015,18,74,57,131
42,15/07/2015,19,37,39,76
42,15/07/2015,20,30,22,52
42,15/07/2015,21,21,13,34
42,15/07/2015,22,18,8,26
42,15/07/2015,23,10,12,22
42,16/07/2015,0,4,2,6
42,16/07/2015,1,3,3,6
42,16/07/2015,2,0,0,0
42,16/07/2015,3,0,0,0
42,16/07/2015,4,1,0,1
42,16/07/2015,5,1,0,1
42,16/07/2015,6,5,14,19
42,16/07/2015,7,13,43,56
42,16/07/2015,8,44,91,135
42,16/07/2015,9,17,72,89
42,16/07/2015,10,14,32,46
42,16/07/2015,11,29,48,77
42,16/07/2015,12,18,28,46
42,16/07/2015,13,23,30,53
42,16/07/2015,14,21,18,39
42,16/07/2015,15,35,18,53
42,16/07/2015,16,47,33,80
42,16/07/2015,17,87,60,147
42,16/07/2015,18,71,48,119
42,16/07/2015,19,34,18,52
42,16/07/2015,20,32,20,52
42,16/07/2015,21,23,10,33
42,16/07/2015,22,10,11,21
42,16/07/2015,23,7,10,17
42,17/07/2015,0,4,3,7
42,17/07/2015,1,1,0,1
42,17/07/2015,2,2,0,2
42,17/07/2015,3,1,0,1
42,17/07/2015,4,0,0,0
42,17/07/2015,5,1,2,3
42,17/07/2015,6,1,3,4
42,17/07/2015,7,6,14,20
42,17/07/2015,8,25,49,74
42,17/07/2015,9,15,58,73
42,17/07/2015,10,10,34,44
42,17/07/2015,11,18,19,37
42,17/07/2015,12,16,25,41
42,17/07/2015,13,29,18,47
42,17/07/2015,14,19,20,39
42,17/07/2015,15,23,21,44
42,17/07/2015,16,31,24,55
42,17/07/2015,17,55,43,98
42,17/07/2015,18,57,27,84
42,17/07/2015,19,23,23,46
42,17/07/2015,20,10,8,18
42,17/07/2015,21,11,4,15
42,17/07/2015,22,8,3,11
42,17/07/2015,23,4,7,11
42,18/07/2015,0,6,6,12
42,18/07/2015,1,3,1,4
42,18/07/2015,2,1,1,2
42,18/07/2015,3,1,0,1
42,18/07/2015,4,1,1,2
42,18/07/2015,5,0,1,1
42,18/07/2015,6,1,2,3
42,18/07/2015,7,1,4,5
42,18/07/2015,8,2,5,7
42,18/07/2015,9,10,15,25
42,18/07/2015,10,11,27,38
42,18/07/2015,11,16,15,31
42,18/07/2015,12,10,22,32
42,18/07/2015,13,14,15,29
42,18/07/2015,14,19,29,48
42,18/07/2015,15,23,12,35
42,18/07/2015,16,20,25,45
42,18/07/2015,17,29,23,52
42,18/07/2015,18,23,16,39
42,18/07/2015,19,12,10,22
42,18/07/2015,20,12,7,19
42,18/07/2015,21,9,10,19
42,18/07/2015,22,7,9,16
42,18/07/2015,23,13,7,20
42,09/08/2015,0,11,7,18
42,09/08/2015,1,11,1,12
42,09/08/2015,2,4,3,7
42,09/08/2015,3,2,0,2
42,09/08/2015,4,1,1,2
42,09/08/2015,5,2,5,7
42,09/08/2015,6,1,8,9
42,09/08/2015,7,3,4,7
42,09/08/2015,8,2,6,8
42,09/08/2015,9,10,20,30
42,09/08/2015,10,9,32,41
42,09/08/2015,11,17,30,47
42,09/08/2015,12,17,24,41
42,09/08/2015,13,29,33,62
42,09/08/2015,14,19,45,64
42,09/08/2015,15,26,39,65
42,09/08/2015,16,35,34,69
42,09/08/2015,17,38,36,74
42,09/08/2015,18,44,29,73
42,09/08/2015,19,50,18,68
42,09/08/2015,20,20,12,32
42,09/08/2015,21,24,16,40
42,09/08/2015,22,13,13,26
42,09/08/2015,23,14,7,21
42,10/08/2015,0,14,4,18
42,10/08/2015,1,7,1,8
42,10/08/2015,2,2,4,6
42,10/08/2015,3,2,0,2
42,10/08/2015,4,2,0,2
42,10/08/2015,5,2,3,5
42,10/08/2015,6,1,15,16
42,10/08/2015,7,19,36,55
42,10/08/2015,8,41,115,156
42,10/08/2015,9,19,66,85
42,10/08/2015,10,15,33,48
42,10/08/2015,11,20,37,57
42,10/08/2015,12,16,32,48
42,10/08/2015,13,20,28,48
42,10/08/2015,14,29,22,51
42,10/08/2015,15,30,32,62
42,10/08/2015,16,54,43,97
42,10/08/2015,17,113,83,196
42,10/08/2015,18,63,48,111
42,10/08/2015,19,38,33,71
42,10/08/2015,20,40,28,68
42,10/08/2015,21,26,25,51
42,10/08/2015,22,20,6,26
42,10/08/2015,23,12,5,17
42,11/08/2015,0,13,2,15
42,11/08/2015,1,9,1,10
42,11/08/2015,2,0,1,1
42,11/08/2015,3,5,1,6
42,11/08/2015,4,5,1,6
42,11/08/2015,5,1,5,6
42,11/08/2015,6,4,19,23
42,11/08/2015,7,11,39,50
42,11/08/2015,8,43,112,155
42,11/08/2015,9,26,77,103
42,11/08/2015,10,14,36,50
42,11/08/2015,11,15,34,49
42,11/08/2015,12,20,43,63
42,11/08/2015,13,20,37,57
42,11/08/2015,14,24,21,45
42,11/08/2015,15,38,33,71
42,11/08/2015,16,51,27,78
42,11/08/2015,17,114,72,186
42,11/08/2015,18,66,49,115
42,11/08/2015,19,50,44,94
42,11/08/2015,20,40,26,66
42,11/08/2015,21,31,16,47
42,11/08/2015,22,17,11,28
42,11/08/2015,23,28,7,35
42,12/08/2015,0,7,1,8
42,12/08/2015,1,11,3,14
42,12/08/2015,2,4,0,4
42,12/08/2015,3,4,0,4
42,12/08/2015,4,3,1,4
42,12/08/2015,5,1,1,2
42,12/08/2015,6,5,21,26
42,12/08/2015,7,20,41,61
42,12/08/2015,8,51,125,176
42,12/08/2015,9,29,77,106
42,12/08/2015,10,18,44,62
42,12/08/2015,11,13,34,47
42,12/08/2015,12,20,21,41
42,12/08/2015,13,23,36,59
42,12/08/2015,14,23,36,59
42,12/08/2015,15,39,41,80
42,12/08/2015,16,60,37,97
42,12/08/2015,17,125,99,224
42,12/08/2015,18,71,63,134
42,12/08/2015,19,51,38,89
42,12/08/2015,20,44,30,74
42,12/08/2015,21,48,20,68
42,12/08/2015,22,15,9,24
42,12/08/2015,23,22,12,34
42,13/08/2015,0,11,6,17
42,13/08/2015,1,8,1,9
42,13/08/2015,2,5,0,5
42,13/08/2015,3,2,0,2
42,13/08/2015,4,1,1,2
42,13/08/2015,5,2,1,3
42,13/08/2015,6,6,11,17
42,13/08/2015,7,15,39,54
42,13/08/2015,8,50,128,178
42,13/08/2015,9,21,77,98
42,13/08/2015,10,33,35,68
42,13/08/2015,11,22,36,58
42,13/08/2015,12,21,42,63
42,13/08/2015,13,28,28,56
42,13/08/2015,14,35,42,77
42,13/08/2015,15,45,23,68
42,13/08/2015,16,62,49,111
42,13/08/2015,17,116,70,186
42,13/08/2015,18,87,72,159
42,13/08/2015,19,50,38,88
42,13/08/2015,20,43,34,77
42,13/08/2015,21,36,20,56
42,13/08/2015,22,19,22,41
42,13/08/2015,23,31,18,49
42,14/08/2015,0,19,8,27
42,14/08/2015,1,12,0,12
42,14/08/2015,2,4,1,5
42,14/08/2015,3,1,1,2
42,14/08/2015,4,2,1,3
42,14/08/2015,5,1,2,3
42,14/08/2015,6,4,6,10
42,14/08/2015,7,6,23,29
42,14/08/2015,8,28,57,85
42,14/08/2015,9,7,45,52
42,14/08/2015,10,7,26,33
42,14/08/2015,11,39,20,59
42,14/08/2015,12,21,20,41
42,14/08/2015,13,21,16,37
42,14/08/2015,14,19,13,32
42,14/08/2015,15,13,15,28
42,14/08/2015,16,42,26,68
42,14/08/2015,17,43,36,79
42,14/08/2015,18,34,15,49
42,14/08/2015,19,36,34,70
42,14/08/2015,20,21,19,40
42,14/08/2015,21,26,6,32
42,14/08/2015,22,15,18,33
42,14/08/2015,23,7,12,19
42,15/08/2015,0,20,5,25
42,15/08/2015,1,10,4,14
42,15/08/2015,2,5,3,8
42,15/08/2015,3,4,0,4
42,15/08/2015,4,1,2,3
42,15/08/2015,5,2,2,4
42,15/08/2015,6,0,3,3
42,15/08/2015,7,4,7,11
42,15/08/2015,8,6,16,22
42,15/08/2015,9,14,38,52
42,15/08/2015,10,21,43,64
42,15/08/2015,11,27,45,72
42,15/08/2015,12,19,31,50
42,15/08/2015,13,27,36,63
42,15/08/2015,14,23,44,67
42,15/08/2015,15,40,34,74
42,15/08/2015,16,59,27,86
42,15/08/2015,17,35,34,69
42,15/08/2015,18,34,26,60
42,15/08/2015,19,37,33,70
42,15/08/2015,20,27,25,52
42,15/08/2015,21,21,14,35
42,15/08/2015,22,19,12,31
42,15/08/2015,23,17,9,26
42,16/08/2015,0,18,6,24
42,16/08/2015,1,4,3,7
42,16/08/2015,2,7,2,9
42,16/08/2015,3,6,1,7
42,16/08/2015,4,6,2,8
42,16/08/2015,5,2,0,2
42,16/08/2015,6,3,2,5
42,16/08/2015,7,1,12,13
42,16/08/2015,8,7,10,17
42,16/08/2015,9,12,18,30
42,16/08/2015,10,17,22,39
42,16/08/2015,11,17,37,54
42,16/08/2015,12,27,34,61
42,16/08/2015,13,33,53,86
42,16/08/2015,14,28,27,55
42,16/08/2015,15,64,47,111
42,16/08/2015,16,33,27,60
42,16/08/2015,17,31,25,56
42,16/08/2015,18,41,31,72
42,16/08/2015,19,41,18,59
42,16/08/2015,20,21,16,37
42,16/08/2015,21,25,18,43
42,16/08/2015,22,28,13,41
42,16/08/2015,23,11,8,19
42,17/08/2015,0,11,3,14
42,17/08/2015,1,7,0,7
42,17/08/2015,2,2,0,2
42,17/08/2015,3,4,1,5
42,17/08/2015,4,3,1,4
42,17/08/2015,5,2,0,2
42,17/08/2015,6,5,14,19
42,17/08/2015,7,15,51,66
42,17/08/2015,8,54,132,186
42,17/08/2015,9,13,83,96
42,17/08/2015,10,22,38,60
42,17/08/2015,11,20,34,54
42,17/08/2015,12,21,45,66
42,17/08/2015,13,37,40,77
42,17/08/2015,14,33,40,73
42,17/08/2015,15,46,37,83
42,17/08/2015,16,71,40,111
42,17/08/2015,17,118,88,206
42,17/08/2015,18,77,46,123
42,17/08/2015,19,64,45,109
42,17/08/2015,20,49,24,73
42,17/08/2015,21,33,34,67
42,17/08/2015,22,15,6,21
42,17/08/2015,23,18,10,28
42,18/08/2015,0,13,4,17
42,18/08/2015,1,3,2,5
42,18/08/2015,2,4,0,4
42,18/08/2015,3,3,2,5
42,18/08/2015,4,0,0,0
42,18/08/2015,5,4,2,6
42,18/08/2015,6,8,12,20
42,18/08/2015,7,20,38,58
42,18/08/2015,8,50,128,178
42,18/08/2015,9,25,77,102
42,18/08/2015,10,10,33,43
42,18/08/2015,11,22,25,47
42,18/08/2015,12,15,31,46
42,18/08/2015,13,18,22,40
42,18/08/2015,14,18,24,42
42,18/08/2015,15,28,15,43
42,18/08/2015,16,50,25,75
42,18/08/2015,17,141,55,196
42,18/08/2015,18,75,62,137
42,18/08/2015,19,42,25,67
42,18/08/2015,20,38,27,65
42,18/08/2015,21,23,17,40
42,18/08/2015,22,17,8,25
42,18/08/2015,23,15,5,20
42,19/08/2015,0,13,7,20
42,19/08/2015,1,7,2,9
42,19/08/2015,2,0,0,0
42,19/08/2015,3,2,1,3
42,19/08/2015,4,1,0,1
42,19/08/2015,5,2,3,5
42,19/08/2015,6,11,17,28
42,19/08/2015,7,17,48,65
42,19/08/2015,8,52,112,164
42,19/08/2015,9,26,84,110
42,19/08/2015,10,16,43,59
42,19/08/2015,11,27,33,60
42,19/08/2015,12,19,23,42
42,19/08/2015,13,26,40,66
42,19/08/2015,14,25,30,55
42,19/08/2015,15,38,33,71
42,19/08/2015,16,62,56,118
42,19/08/2015,17,119,81,200
42,19/08/2015,18,58,48,106
42,19/08/2015,19,41,27,68
42,19/08/2015,20,31,24,55
42,19/08/2015,21,27,22,49
42,19/08/2015,22,27,8,35
42,19/08/2015,23,17,6,23
42,20/08/2015,0,8,8,16
42,20/08/2015,1,5,2,7
42,20/08/2015,2,5,1,6
42,20/08/2015,3,2,1,3
42,20/08/2015,4,1,0,1
42,20/08/2015,5,5,4,9
42,20/08/2015,6,6,16,22
42,20/08/2015,7,27,41,68
42,20/08/2015,8,42,141,183
42,20/08/2015,9,21,85,106
42,20/08/2015,10,17,36,53
42,20/08/2015,11,19,31,50
42,20/08/2015,12,15,21,36
42,20/08/2015,13,34,37,71
42,20/08/2015,14,29,34,63
42,20/08/2015,15,53,47,100
42,20/08/2015,16,76,53,129
42,20/08/2015,17,110,70,180
42,20/08/2015,18,77,52,129
42,20/08/2015,19,67,35,102
42,20/08/2015,20,59,33,92
42,20/08/2015,21,28,25,53
42,20/08/2015,22,14,8,22
42,20/08/2015,23,20,16,36
42,21/08/2015,0,15,10,25
42,21/08/2015,1,12,5,17
42,21/08/2015,2,7,1,8
42,21/08/2015,3,3,3,6
42,21/08/2015,4,1,3,4
42,21/08/2015,5,3,3,6
42,21/08/2015,6,4,13,17
42,21/08/2015,7,12,44,56
42,21/08/2015,8,38,105,143
42,21/08/2015,9,28,75,103
42,21/08/2015,10,16,53,69
42,21/08/2015,11,20,29,49
42,21/08/2015,12,39,25,64
42,21/08/2015,13,27,45,72
42,21/08/2015,14,27,18,45
42,21/08/2015,15,34,32,66
42,21/08/2015,16,81,49,130
42,21/08/2015,17,94,59,153
42,21/08/2015,18,50,34,84
42,21/08/2015,19,48,41,89
42,21/08/2015,20,26,22,48
42,21/08/2015,21,14,16,30
42,21/08/2015,22,20,15,35
42,21/08/2015,23,18,14,32
42,22/08/2015,0,15,14,29
42,22/08/2015,1,9,4,13
42,22/08/2015,2,5,1,6
42,22/08/2015,3,6,1,7
42,22/08/2015,4,5,1,6
42,22/08/2015,5,1,3,4
42,22/08/2015,6,1,5,6
42,22/08/2015,7,5,10,15
42,22/08/2015,8,8,13,21
42,22/08/2015,9,17,25,42
42,22/08/2015,10,21,44,65
42,22/08/2015,11,27,32,59
42,22/08/2015,12,35,24,59
42,22/08/2015,13,21,24,45
42,22/08/2015,14,22,35,57
42,22/08/2015,15,40,34,74
42,22/08/2015,16,27,21,48
42,22/08/2015,17,45,33,78
42,22/08/2015,18,45,24,69
42,22/08/2015,19,18,22,40
42,22/08/2015,20,27,17,44
42,22/08/2015,21,11,9,20
42,22/08/2015,22,20,12,32
42,22/08/2015,23,21,5,26
42,23/08/2015,0,6,4,10
42,23/08/2015,1,7,5,12
42,23/08/2015,2,2,2,4
42,23/08/2015,3,6,1,7
42,23/08/2015,4,5,1,6
42,23/08/2015,5,3,0,3
42,23/08/2015,6,1,2,3
42,23/08/2015,7,3,2,5
42,23/08/2015,8,12,7,19
42,23/08/2015,9,17,36,53
42,23/08/2015,10,17,43,60
42,23/08/2015,11,29,41,70
42,23/08/2015,12,49,43,92
42,23/08/2015,13,35,54,89
42,23/08/2015,14,30,50,80
42,23/08/2015,15,40,58,98
42,23/08/2015,16,60,46,106
42,23/08/2015,17,47,40,87
42,23/08/2015,18,55,55,110
42,23/08/2015,19,35,26,61
42,23/08/2015,20,38,15,53
42,23/08/2015,21,30,12,42
42,23/08/2015,22,9,16,25
42,23/08/2015,23,14,10,24
42,24/08/2015,0,11,8,19
42,24/08/2015,1,5,2,7
42,24/08/2015,2,6,3,9
42,24/08/2015,3,5,0,5
42,24/08/2015,4,3,0,3
42,24/08/2015,5,2,0,2
42,24/08/2015,6,5,13,18
42,24/08/2015,7,13,46,59
42,24/08/2015,8,44,129,173
42,24/08/2015,9,18,82,100
42,24/08/2015,10,20,33,53
42,24/08/2015,11,21,33,54
42,24/08/2015,12,29,35,64
42,24/08/2015,13,32,33,65
42,24/08/2015,14,30,24,54
42,24/08/2015,15,36,29,65
42,24/08/2015,16,66,48,114
42,24/08/2015,17,123,82,205
42,24/08/2015,18,78,51,129
42,24/08/2015,19,46,44,90
42,24/08/2015,20,35,23,58
42,24/08/2015,21,25,16,41
42,24/08/2015,22,20,18,38
42,24/08/2015,23,10,8,18
42,25/08/2015,0,10,3,13
42,25/08/2015,1,2,2,4
42,25/08/2015,2,8,1,9
42,25/08/2015,3,2,0,2
42,25/08/2015,4,1,1,2
42,25/08/2015,5,2,3,5
42,25/08/2015,6,4,12,16
42,25/08/2015,7,15,55,70
42,25/08/2015,8,53,111,164
42,25/08/2015,9,27,79,106
42,25/08/2015,10,20,40,60
42,25/08/2015,11,13,40,53
42,25/08/2015,12,17,33,50
42,25/08/2015,13,34,40,74
42,25/08/2015,14,33,36,69
42,25/08/2015,15,54,46,100
42,25/08/2015,16,69,42,111
42,25/08/2015,17,144,85,229
42,25/08/2015,18,93,85,178
42,25/08/2015,19,50,40,90
42,25/08/2015,20,37,30,67
42,25/08/2015,21,28,23,51
42,25/08/2015,22,25,12,37
42,25/08/2015,23,12,14,26
42,26/08/2015,0,12,2,14
42,26/08/2015,1,10,1,11
42,26/08/2015,2,2,0,2
42,26/08/2015,3,3,0,3
42,26/08/2015,4,0,1,1
42,26/08/2015,5,0,4,4
42,26/08/2015,6,6,15,21
42,26/08/2015,7,18,46,64
42,26/08/2015,8,41,107,148
42,26/08/2015,9,22,63,85
42,26/08/2015,10,16,37,53
42,26/08/2015,11,8,25,33
42,26/08/2015,12,24,33,57
42,26/08/2015,13,27,26,53
42,26/08/2015,14,21,32,53
42,26/08/2015,15,45,26,71
42,26/08/2015,16,53,38,91
42,26/08/2015,17,78,60,138
42,26/08/2015,18,72,51,123
42,26/08/2015,19,39,34,73
42,26/08/2015,20,39,17,56
42,26/08/2015,21,28,13,41
42,26/08/2015,22,21,9,30
42,26/08/2015,23,13,9,22
42,27/08/2015,0,6,5,11
42,27/08/2015,1,10,2,12
42,27/08/2015,2,3,0,3
42,27/08/2015,3,0,2,2
42,27/08/2015,4,3,1,4
42,27/08/2015,5,4,3,7
42,27/08/2015,6,4,15,19
42,27/08/2015,7,18,48,66
42,27/08/2015,8,46,117,163
42,27/08/2015,9,17,75,92
42,27/08/2015,10,16,31,47
42,27/08/2015,11,21,22,43
42,27/08/2015,12,18,14,32
42,27/08/2015,13,21,35,56
42,27/08/2015,14,28,21,49
42,27/08/2015,15,36,21,57
42,27/08/2015,16,54,41,95
42,27/08/2015,17,93,68,161
42,27/08/2015,18,70,65,135
42,27/08/2015,19,34,22,56
42,27/08/2015,20,39,20,59
42,27/08/2015,21,26,21,47
42,27/08/2015,22,21,15,36
42,27/08/2015,23,18,10,28
42,28/08/2015,0,8,6,14
42,28/08/2015,1,5,1,6
42,28/08/2015,2,5,0,5
42,28/08/2015,3,3,1,4
42,28/08/2015,4,0,1,1
42,28/08/2015,5,4,5,9
42,28/08/2015,6,5,15,20
42,28/08/2015,7,12,49,61
42,28/08/2015,8,36,100,136
42,28/08/2015,9,22,63,85
42,28/08/2015,10,22,37,59
42,28/08/2015,11,21,25,46
42,28/08/2015,12,29,27,56
42,28/08/2015,13,21,39,60
42,28/08/2015,14,22,30,52
42,28/08/2015,15,44,31,75
42,28/08/2015,16,41,45,86
42,28/08/2015,17,82,57,139
42,28/08/2015,18,42,33,75
42,28/08/2015,19,43,46,89
42,28/08/2015,20,23,24,47
42,28/08/2015,21,15,18,33
42,28/08/2015,22,26,18,44
42,28/08/2015,23,14,11,25
42,29/08/2015,0,20,6,26
42,29/08/2015,1,5,3,8
42,29/08/2015,2,7,1,8
42,29/08/2015,3,2,2,4
42,29/08/2015,4,3,1,4
42,29/08/2015,5,2,5,7
42,29/08/2015,6,1,2,3
42,29/08/2015,7,6,9,15
42,29/08/2015,8,10,14,24
42,29/08/2015,9,11,25,36
42,29/08/2015,10,24,32,56
42,29/08/2015,11,19,29,48
42,29/08/2015,12,23,47,70
42,29/08/2015,13,28,29,57
42,29/08/2015,14,21,26,47
42,29/08/2015,15,32,31,63
42,29/08/2015,16,26,25,51
42,29/08/2015,17,28,27,55
42,29/08/2015,18,22,27,49
42,29/08/2015,19,29,21,50
42,29/08/2015,20,15,13,28
42,29/08/2015,21,16,17,33
42,29/08/2015,22,21,19,40
42,29/08/2015,23,18,6,24
42,30/08/2015,0,10,8,18
42,30/08/2015,1,7,3,10
42,30/08/2015,2,8,4,12
42,30/08/2015,3,5,0,5
42,30/08/2015,4,5,0,5
42,30/08/2015,5,1,1,2
42,30/08/2015,6,0,0,0
42,30/08/2015,7,7,3,10
42,30/08/2015,8,9,23,32
42,30/08/2015,9,15,27,42
42,30/08/2015,10,26,37,63
42,30/08/2015,11,38,32,70
42,30/08/2015,12,31,25,56
42,30/08/2015,13,26,37,63
42,30/08/2015,14,34,46,80
42,30/08/2015,15,46,36,82
42,30/08/2015,16,42,46,88
42,30/08/2015,17,61,26,87
42,30/08/2015,18,37,21,58
42,30/08/2015,19,31,21,52
42,30/08/2015,20,24,25,49
42,30/08/2015,21,19,19,38
42,30/08/2015,22,10,3,13
42,30/08/2015,23,16,5,21
42,31/08/2015,0,7,4,11
42,31/08/2015,1,2,4,6
42,31/08/2015,2,3,0,3
42,31/08/2015,3,3,1,4
42,31/08/2015,4,1,0,1
42,31/08/2015,5,2,3,5
42,31/08/2015,6,7,11,18
42,31/08/2015,7,12,45,57
42,31/08/2015,8,32,107,139
42,31/08/2015,9,25,77,102
42,31/08/2015,10,14,36,50
42,31/08/2015,11,14,25,39
42,31/08/2015,12,29,23,52
42,31/08/2015,13,35,38,73
42,31/08/2015,14,38,29,67
42,31/08/2015,15,34,39,73
42,31/08/2015,16,63,54,117
42,31/08/2015,17,118,55,173
42,31/08/2015,18,63,39,102
42,31/08/2015,19,47,22,69
42,31/08/2015,20,27,21,48
42,31/08/2015,21,16,25,41
42,31/08/2015,22,21,8,29
42,31/08/2015,23,11,3,14
42,01/09/2015,0,3,2,5
42,01/09/2015,1,5,5,10
42,01/09/2015,2,3,4,7
42,01/09/2015,3,1,1,2
42,01/09/2015,4,0,0,0
42,01/09/2015,5,0,1,1
42,01/09/2015,6,5,12,17
42,01/09/2015,7,25,45,70
42,01/09/2015,8,43,125,168
42,01/09/2015,9,22,79,101
42,01/09/2015,10,15,31,46
42,01/09/2015,11,22,29,51
42,01/09/2015,12,13,30,43
42,01/09/2015,13,22,23,45
42,01/09/2015,14,24,21,45
42,01/09/2015,15,38,21,59
42,01/09/2015,16,60,41,101
42,01/09/2015,17,90,51,141
42,01/09/2015,18,69,49,118
42,01/09/2015,19,39,12,51
42,01/09/2015,20,19,17,36
42,01/09/2015,21,11,6,17
42,01/09/2015,22,8,9,17
42,01/09/2015,23,7,1,8
42,02/09/2015,0,5,5,10
42,02/09/2015,1,0,3,3
42,02/09/2015,2,4,0,4
42,02/09/2015,3,0,0,0
42,02/09/2015,4,0,1,1
42,02/09/2015,5,0,2,2
42,02/09/2015,6,8,12,20
42,02/09/2015,7,20,57,77
42,02/09/2015,8,44,125,169
42,02/09/2015,9,17,75,92
42,02/09/2015,10,16,26,42
42,02/09/2015,11,9,13,22
42,02/09/2015,12,14,21,35
42,02/09/2015,13,22,34,56
42,02/09/2015,14,19,21,40
42,02/09/2015,15,44,23,67
42,02/09/2015,16,51,40,91
42,02/09/2015,17,119,64,183
42,02/09/2015,18,63,46,109
42,02/09/2015,19,41,28,69
42,02/09/2015,20,32,14,46
42,02/09/2015,21,16,9,25
42,02/09/2015,22,10,4,14
42,02/09/2015,23,10,7,17
42,03/09/2015,0,6,4,10
42,03/09/2015,1,2,1,3
42,03/09/2015,2,1,0,1
42,03/09/2015,3,0,0,0
42,03/09/2015,4,0,1,1
42,03/09/2015,5,0,4,4
42,03/09/2015,6,8,9,17
42,03/09/2015,7,20,66,86
42,03/09/2015,8,52,104,156
42,03/09/2015,9,36,84,120
42,03/09/2015,10,17,36,53
42,03/09/2015,11,11,14,25
42,03/09/2015,12,20,32,52
42,03/09/2015,13,18,27,45
42,03/09/2015,14,38,22,60
42,03/09/2015,15,32,30,62
42,03/09/2015,16,47,38,85
42,03/09/2015,17,104,53,157
42,03/09/2015,18,70,53,123
42,03/09/2015,19,40,32,72
42,03/09/2015,20,34,24,58
42,03/09/2015,21,15,8,23
42,03/09/2015,22,9,11,20
42,03/09/2015,23,11,7,18
42,04/09/2015,0,1,4,5
42,04/09/2015,1,3,1,4
42,04/09/2015,2,0,1,1
42,04/09/2015,3,0,0,0
42,04/09/2015,4,1,0,1
42,04/09/2015,5,0,3,3
42,04/09/2015,6,7,15,22
42,04/09/2015,7,16,43,59
42,04/09/2015,8,45,82,127
42,04/09/2015,9,18,72,90
42,04/09/2015,10,13,18,31
42,04/09/2015,11,14,26,40
42,04/09/2015,12,28,22,50
42,04/09/2015,13,16,19,35
42,04/09/2015,14,31,24,55
42,04/09/2015,15,44,33,77
42,04/09/2015,16,56,49,105
42,04/09/2015,17,90,50,140
42,04/09/2015,18,48,22,70
42,04/09/2015,19,37,17,54
42,04/09/2015,20,23,13,36
42,04/09/2015,21,7,12,19
42,04/09/2015,22,10,6,16
42,04/09/2015,23,5,4,9
42,05/09/2015,0,6,9,15
42,05/09/2015,1,3,1,4
42,05/09/2015,2,1,2,3
42,05/09/2015,3,1,2,3
42,05/09/2015,4,1,0,1
42,05/09/2015,5,1,0,1
42,05/09/2015,6,2,1,3
42,05/09/2015,7,3,10,13
42,05/09/2015,8,10,12,22
42,05/09/2015,9,11,30,41
42,05/09/2015,10,19,21,40
42,05/09/2015,11,28,19,47
42,05/09/2015,12,29,29,58
42,05/09/2015,13,15,16,31
42,05/09/2015,14,20,28,48
42,05/09/2015,15,28,27,55
42,05/09/2015,16,25,20,45
42,05/09/2015,17,33,28,61
42,05/09/2015,18,33,22,55
42,05/09/2015,19,17,18,35
42,05/09/2015,20,20,10,30
42,05/09/2015,21,10,7,17
42,05/09/2015,22,11,10,21
42,05/09/2015,23,2,5,7
42,06/09/2015,0,3,4,7
42,06/09/2015,1,1,5,6
42,06/09/2015,2,1,0,1
42,06/09/2015,3,0,2,2
42,06/09/2015,4,0,0,0
42,06/09/2015,5,2,2,4
42,06/09/2015,6,5,0,5
42,06/09/2015,7,4,7,11
42,06/09/2015,8,14,6,20
42,06/09/2015,9,22,18,40
42,06/09/2015,10,15,35,50
42,06/09/2015,11,30,37,67
42,06/09/2015,12,37,38,75
42,06/09/2015,13,37,39,76
42,06/09/2015,14,39,30,69
42,06/09/2015,15,39,34,73
42,06/09/2015,16,34,43,77
42,06/09/2015,17,31,35,66
42,06/09/2015,18,32,20,52
42,06/09/2015,19,27,18,45
42,06/09/2015,20,14,10,24
42,06/09/2015,21,10,8,18
42,06/09/2015,22,4,1,5
42,06/09/2015,23,6,5,11
42,07/09/2015,0,1,0,1
42,07/09/2015,1,0,1,1
42,07/09/2015,2,3,1,4
42,07/09/2015,3,0,0,0
42,07/09/2015,4,0,0,0
42,07/09/2015,5,0,1,1
42,07/09/2015,6,5,10,15
42,07/09/2015,7,21,54,75
42,07/09/2015,8,60,123,183
42,07/09/2015,9,18,75,93
42,07/09/2015,10,13,43,56
42,07/09/2015,11,19,24,43
42,07/09/2015,12,17,26,43
42,07/09/2015,13,25,33,58
42,07/09/2015,14,35,26,61
42,07/09/2015,15,55,36,91
42,07/09/2015,16,59,49,108
42,07/09/2015,17,109,77,186
42,07/09/2015,18,82,55,137
42,07/09/2015,19,53,42,95
42,07/09/2015,20,31,13,44
42,07/09/2015,21,16,10,26
42,07/09/2015,22,15,9,24
42,07/09/2015,23,10,8,18
42,08/09/2015,0,4,3,7
42,08/09/2015,1,2,3,5
42,08/09/2015,2,0,1,1
42,08/09/2015,3,0,2,2
42,08/09/2015,4,1,1,2
42,08/09/2015,5,0,3,3
42,08/09/2015,6,10,20,30
42,08/09/2015,7,16,46,62
42,08/09/2015,8,54,127,181
42,08/09/2015,9,20,87,107
42,08/09/2015,10,14,27,41
42,08/09/2015,11,14,21,35
42,08/09/2015,12,24,22,46
42,08/09/2015,13,19,31,50
42,08/09/2015,14,26,22,48
42,08/09/2015,15,38,24,62
42,08/09/2015,16,59,32,91
42,08/09/2015,17,114,71,185
42,08/09/2015,18,62,57,119
42,08/09/2015,19,29,34,63
42,08/09/2015,20,27,14,41
42,08/09/2015,21,21,8,29
42,08/09/2015,22,13,7,20
42,08/09/2015,23,2,2,4
42,09/09/2015,0,7,1,8
42,09/09/2015,1,3,2,5
42,09/09/2015,2,0,1,1
42,09/09/2015,3,0,0,0
42,09/09/2015,4,0,1,1
42,09/09/2015,5,0,4,4
42,09/09/2015,6,6,14,20
42,09/09/2015,7,19,59,78
42,09/09/2015,8,52,147,199
42,09/09/2015,9,22,89,111
42,09/09/2015,10,29,33,62
42,09/09/2015,11,17,22,39
42,09/09/2015,12,26,24,50
42,09/09/2015,13,23,32,55
42,09/09/2015,14,17,22,39
42,09/09/2015,15,34,29,63
42,09/09/2015,16,62,44,106
42,09/09/2015,17,98,77,175
42,09/09/2015,18,65,40,105
42,09/09/2015,19,38,32,70
42,09/09/2015,20,29,11,40
42,09/09/2015,21,16,8,24
42,09/09/2015,22,19,9,28
42,09/09/2015,23,4,7,11
42,10/09/2015,0,1,3,4
42,10/09/2015,1,0,2,2
42,10/09/2015,2,2,1,3
42,10/09/2015,3,0,1,1
42,10/09/2015,4,0,0,0
42,10/09/2015,5,1,4,5
42,10/09/2015,6,2,19,21
42,10/09/2015,7,23,47,70
42,10/09/2015,8,48,119,167
42,10/09/2015,9,26,76,102
42,10/09/2015,10,16,32,48
42,10/09/2015,11,24,19,43
42,10/09/2015,12,20,33,53
42,10/09/2015,13,23,19,42
42,10/09/2015,14,35,23,58
42,10/09/2015,15,38,25,63
42,10/09/2015,16,89,62,151
42,10/09/2015,17,99,78,177
42,10/09/2015,18,64,60,124
42,10/09/2015,19,46,37,83
42,10/09/2015,20,35,18,53
42,10/09/2015,21,10,10,20
42,10/09/2015,22,17,7,24
42,10/09/2015,23,13,9,22
42,11/09/2015,0,3,3,6
42,11/09/2015,1,2,2,4
42,11/09/2015,2,2,0,2
42,11/09/2015,3,0,0,0
42,11/09/2015,4,0,0,0
42,11/09/2015,5,1,3,4
42,11/09/2015,6,7,14,21
42,11/09/2015,7,18,37,55
42,11/09/2015,8,43,85,128
42,11/09/2015,9,21,63,84
42,11/09/2015,10,14,29,43
42,11/09/2015,11,23,30,53
42,11/09/2015,12,18,23,41
42,11/09/2015,13,33,36,69
42,11/09/2015,14,27,13,40
42,11/09/2015,15,35,29,64
42,11/09/2015,16,59,52,111
42,11/09/2015,17,82,57,139
42,11/09/2015,18,57,35,92
42,11/09/2015,19,27,24,51
42,11/09/2015,20,34,16,50
42,11/09/2015,21,9,14,23
42,11/09/2015,22,6,9,15
42,11/09/2015,23,7,11,18
42,12/09/2015,0,5,5,10
42,12/09/2015,1,7,3,10
42,12/09/2015,2,3,1,4
42,12/09/2015,3,2,3,5
42,12/09/2015,4,0,1,1
42,12/09/2015,5,0,1,1
42,12/09/2015,6,1,5,6
42,12/09/2015,7,2,5,7
42,12/09/2015,8,12,13,25
42,12/09/2015,9,17,21,38
42,12/09/2015,10,23,29,52
42,12/09/2015,11,16,15,31
42,12/09/2015,12,16,26,42
42,12/09/2015,13,10,14,24
42,12/09/2015,14,12,23,35
42,12/09/2015,15,26,22,48
42,12/09/2015,16,22,23,45
42,12/09/2015,17,32,22,54
42,12/09/2015,18,15,26,41
42,12/09/2015,19,20,16,36
42,12/09/2015,20,11,8,19
42,12/09/2015,21,10,4,14
42,12/09/2015,22,10,16,26
42,12/09/2015,23,14,5,19
42,13/09/2015,0,2,8,10
42,13/09/2015,1,4,1,5
42,13/09/2015,2,1,1,2
42,13/09/2015,3,0,1,1
42,13/09/2015,4,2,1,3
42,13/09/2015,5,0,2,2
42,13/09/2015,6,3,6,9
42,13/09/2015,7,0,5,5
42,13/09/2015,8,4,10,14
42,13/09/2015,9,10,20,30
42,13/09/2015,10,13,27,40
42,13/09/2015,11,34,18,52
42,13/09/2015,12,25,29,54
42,13/09/2015,13,33,25,58
42,13/09/2015,14,29,26,55
42,13/09/2015,15,26,27,53
42,13/09/2015,16,45,27,72
42,13/09/2015,17,24,24,48
42,13/09/2015,18,27,18,45
42,13/09/2015,19,16,11,27
42,13/09/2015,20,8,10,18
42,13/09/2015,21,9,7,16
42,13/09/2015,22,9,8,17
42,13/09/2015,23,0,2,2
42,14/09/2015,0,2,4,6
42,14/09/2015,1,1,3,4
42,14/09/2015,2,1,1,2
42,14/09/2015,3,0,0,0
42,14/09/2015,4,0,0,0
42,14/09/2015,5,0,2,2
42,14/09/2015,6,7,12,19
42,14/09/2015,7,18,45,63
42,14/09/2015,8,53,115,168
42,14/09/2015,9,22,89,111
42,14/09/2015,10,12,31,43
42,14/09/2015,11,14,15,29
42,14/09/2015,12,7,16,23
42,14/09/2015,13,14,22,36
42,14/09/2015,14,20,15,35
42,14/09/2015,15,25,20,45
42,14/09/2015,16,50,21,71
42,14/09/2015,17,91,67,158
42,14/09/2015,18,63,46,109
42,14/09/2015,19,34,30,64
42,14/09/2015,20,20,13,33
42,14/09/2015,21,18,8,26
42,14/09/2015,22,11,5,16
42,14/09/2015,23,4,1,5
42,15/09/2015,0,6,4,10
42,15/09/2015,1,2,2,4
42,15/09/2015,2,0,0,0
42,15/09/2015,3,0,0,0
42,15/09/2015,4,0,0,0
42,15/09/2015,5,0,2,2
42,15/09/2015,6,7,16,23
42,15/09/2015,7,17,47,64
42,15/09/2015,8,51,122,173
42,15/09/2015,9,19,93,112
42,15/09/2015,10,13,39,52
42,15/09/2015,11,12,22,34
42,15/09/2015,12,48,22,70
42,15/09/2015,13,25,41,66
42,15/09/2015,14,37,39,76
42,15/09/2015,15,39,30,69
42,15/09/2015,16,66,49,115
42,15/09/2015,17,118,80,198
42,15/09/2015,18,88,55,143
42,15/09/2015,19,40,24,64
42,15/09/2015,20,54,15,69
42,15/09/2015,21,19,22,41
42,15/09/2015,22,14,7,21
42,15/09/2015,23,7,8,15
42,16/09/2015,0,4,3,7
42,16/09/2015,1,4,0,4
42,16/09/2015,2,0,0,0
42,16/09/2015,3,1,1,2
42,16/09/2015,4,0,0,0
42,16/09/2015,5,2,1,3
42,16/09/2015,6,8,14,22
42,16/09/2015,7,23,48,71
42,16/09/2015,8,51,117,168
42,16/09/2015,9,14,96,110
42,16/09/2015,10,20,43,63
42,16/09/2015,11,14,23,37
42,16/09/2015,12,31,30,61
42,16/09/2015,13,30,44,74
42,16/09/2015,14,36,34,70
42,16/09/2015,15,46,26,72
42,16/09/2015,16,91,47,138
42,16/09/2015,17,123,86,209
42,16/09/2015,18,71,57,128
42,16/09/2015,19,56,36,92
42,16/09/2015,20,30,19,49
42,16/09/2015,21,16,10,26
42,16/09/2015,22,15,12,27
42,16/09/2015,23,12,11,23
42,17/09/2015,0,6,4,10
42,17/09/2015,1,1,2,3
42,17/09/2015,2,2,1,3
42,17/09/2015,3,1,0,1
42,17/09/2015,4,1,0,1
42,17/09/2015,5,0,1,1
42,17/09/2015,6,6,13,19
42,17/09/2015,7,16,43,59
42,17/09/2015,8,48,128,176
42,17/09/2015,9,26,82,108
42,17/09/2015,10,11,40,51
42,17/09/2015,11,16,31,47
42,17/09/2015,12,33,28,61
42,17/09/2015,13,33,32,65
42,17/09/2015,14,31,27,58
42,17/09/2015,15,34,19,53
42,17/09/2015,16,70,44,114
42,17/09/2015,17,114,63,177
42,17/09/2015,18,61,54,115
42,17/09/2015,19,37,28,65
42,17/09/2015,20,37,15,52
42,17/09/2015,21,11,15,26
42,17/09/2015,22,12,7,19
42,17/09/2015,23,10,9,19
42,18/09/2015,0,2,4,6
42,18/09/2015,1,3,1,4
42,18/09/2015,2,1,3,4
42,18/09/2015,3,1,1,2
42,18/09/2015,4,0,0,0
42,18/09/2015,5,0,1,1
42,18/09/2015,6,5,11,16
42,18/09/2015,7,11,31,42
42,18/09/2015,8,32,92,124
42,18/09/2015,9,23,68,91
42,18/09/2015,10,15,41,56
42,18/09/2015,11,33,25,58
42,18/09/2015,12,27,26,53
42,18/09/2015,13,21,39,60
42,18/09/2015,14,31,27,58
42,18/09/2015,15,33,27,60
42,18/09/2015,16,52,43,95
42,18/09/2015,17,78,64,142
42,18/09/2015,18,62,39,101
42,18/09/2015,19,34,38,72
42,18/09/2015,20,24,15,39
42,18/09/2015,21,21,10,31
42,18/09/2015,22,7,10,17
42,18/09/2015,23,11,6,17
42,19/09/2015,0,6,2,8
42,19/09/2015,1,6,0,6
42,19/09/2015,2,7,5,12
42,19/09/2015,3,3,5,8
42,19/09/2015,4,1,1,2
42,19/09/2015,5,1,0,1
42,19/09/2015,6,0,3,3
42,19/09/2015,7,3,8,11
42,19/09/2015,8,5,11,16
42,19/09/2015,9,21,31,52
42,19/09/2015,10,30,43,73
42,19/09/2015,11,27,35,62
42,19/09/2015,12,34,34,68
42,19/09/2015,13,33,44,77
42,19/09/2015,14,33,36,69
42,19/09/2015,15,32,31,63
42,19/09/2015,16,33,21,54
42,19/09/2015,17,51,21,72
42,19/09/2015,18,18,16,34
42,19/09/2015,19,16,48,64
42,19/09/2015,20,16,10,26
42,19/09/2015,21,10,7,17
42,19/09/2015,22,6,5,11
42,19/09/2015,23,3,11,14
42,20/09/2015,0,3,4,7
42,20/09/2015,1,2,2,4
42,20/09/2015,2,2,2,4
42,20/09/2015,3,2,0,2
42,20/09/2015,4,1,1,2
42,20/09/2015,5,0,1,1
42,20/09/2015,6,0,4,4
42,20/09/2015,7,5,4,9
42,20/09/2015,8,1,9,10
42,20/09/2015,9,8,21,29
42,20/09/2015,10,18,25,43
42,20/09/2015,11,22,20,42
42,20/09/2015,12,23,19,42
42,20/09/2015,13,17,33,50
42,20/09/2015,14,29,28,57
42,20/09/2015,15,31,32,63
42,20/09/2015,16,31,17,48
42,20/09/2015,17,30,28,58
42,20/09/2015,18,31,20,51
42,20/09/2015,19,26,11,37
42,20/09/2015,20,13,9,22
42,20/09/2015,21,3,13,16
42,20/09/2015,22,4,10,14
42,20/09/2015,23,4,8,12
42,21/09/2015,0,3,2,5
42,21/09/2015,1,3,1,4
42,21/09/2015,2,1,1,2
42,21/09/2015,3,0,0,0
42,21/09/2015,4,0,0,0
42,21/09/2015,5,1,3,4
42,21/09/2015,6,5,7,12
42,21/09/2015,7,11,32,43
42,21/09/2015,8,23,89,112
42,21/09/2015,9,17,56,73
42,21/09/2015,10,7,31,38
42,21/09/2015,11,21,28,49
42,21/09/2015,12,16,17,33
42,21/09/2015,13,24,28,52
42,21/09/2015,14,24,29,53
42,21/09/2015,15,29,39,68
42,21/09/2015,16,59,31,90
42,21/09/2015,17,98,53,151
42,21/09/2015,18,66,35,101
42,21/09/2015,19,47,31,78
42,21/09/2015,20,34,14,48
42,21/09/2015,21,25,21,46
42,21/09/2015,22,17,8,25
42,21/09/2015,23,12,3,15
42,22/09/2015,0,8,3,11
42,22/09/2015,1,3,1,4
42,22/09/2015,2,0,0,0
42,22/09/2015,3,0,0,0
42,22/09/2015,4,1,0,1
42,22/09/2015,5,1,4,5
42,22/09/2015,6,5,15,20
42,22/09/2015,7,22,44,66
42,22/09/2015,8,51,140,191
42,22/09/2015,9,18,116,134
42,22/09/2015,10,23,45,68
42,22/09/2015,11,23,19,42
42,22/09/2015,12,15,35,50
42,22/09/2015,13,33,36,69
42,22/09/2015,14,30,30,60
42,22/09/2015,15,46,43,89
42,22/09/2015,16,76,65,141
42,22/09/2015,17,119,77,196
42,22/09/2015,18,98,62,160
42,22/09/2015,19,49,41,90
42,22/09/2015,20,42,12,54
42,22/09/2015,21,35,3,38
42,22/09/2015,22,15,7,22
42,22/09/2015,23,9,6,15
42,23/09/2015,0,2,4,6
42,23/09/2015,1,2,2,4
42,23/09/2015,2,0,0,0
42,23/09/2015,3,0,0,0
42,23/09/2015,4,0,0,0
42,23/09/2015,5,3,5,8
42,23/09/2015,6,4,17,21
42,23/09/2015,7,23,51,74
42,23/09/2015,8,55,136,191
42,23/09/2015,9,29,101,130
42,23/09/2015,10,24,45,69
42,23/09/2015,11,18,33,51
42,23/09/2015,12,32,42,74
42,23/09/2015,13,34,33,67
42,23/09/2015,14,33,38,71
42,23/09/2015,15,37,24,61
42,23/09/2015,16,65,45,110
42,23/09/2015,17,114,61,175
42,23/09/2015,18,79,70,149
42,23/09/2015,19,53,28,81
42,23/09/2015,20,34,21,55
42,23/09/2015,21,21,4,25
42,23/09/2015,22,16,10,26
42,23/09/2015,23,5,7,12
42,24/09/2015,0,5,3,8
42,24/09/2015,1,2,0,2
42,24/09/2015,2,0,0,0
42,24/09/2015,3,0,2,2
42,24/09/2015,4,0,0,0
42,24/09/2015,5,2,3,5
42,24/09/2015,6,4,11,15
42,24/09/2015,7,21,35,56
42,24/09/2015,8,58,133,191
42,24/09/2015,9,30,95,125
42,24/09/2015,10,20,39,59
42,24/09/2015,11,23,36,59
42,24/09/2015,12,38,36,74
42,24/09/2015,13,32,31,63
42,24/09/2015,14,32,26,58
42,24/09/2015,15,28,21,49
42,24/09/2015,16,61,39,100
42,24/09/2015,17,111,58,169
42,24/09/2015,18,89,58,147
42,24/09/2015,19,33,23,56
42,24/09/2015,20,25,13,38
42,24/09/2015,21,28,12,40
42,24/09/2015,22,16,13,29
42,24/09/2015,23,8,3,11
42,25/09/2015,0,5,1,6
42,25/09/2015,1,4,0,4
42,25/09/2015,2,3,0,3
42,25/09/2015,3,0,0,0
42,25/09/2015,4,0,0,0
42,25/09/2015,5,1,2,3
42,25/09/2015,6,4,10,14
42,25/09/2015,7,16,45,61
42,25/09/2015,8,38,118,156
42,25/09/2015,9,23,67,90
42,25/09/2015,10,22,42,64
42,25/09/2015,11,21,36,57
42,25/09/2015,12,37,25,62
42,25/09/2015,13,33,40,73
42,25/09/2015,14,43,32,75
42,25/09/2015,15,50,31,81
42,25/09/2015,16,58,38,96
42,25/09/2015,17,100,66,166
42,25/09/2015,18,64,43,107
42,25/09/2015,19,38,30,68
42,25/09/2015,20,20,14,34
42,25/09/2015,21,18,12,30
42,25/09/2015,22,16,6,22
42,25/09/2015,23,9,8,17
42,26/09/2015,0,9,1,10
42,26/09/2015,1,4,4,8
42,26/09/2015,2,0,1,1
42,26/09/2015,3,6,2,8
42,26/09/2015,4,0,1,1
42,26/09/2015,5,6,1,7
42,26/09/2015,6,0,2,2
42,26/09/2015,7,3,12,15
42,26/09/2015,8,10,17,27
42,26/09/2015,9,15,42,57
42,26/09/2015,10,12,55,67
42,26/09/2015,11,29,39,68
42,26/09/2015,12,35,26,61
42,26/09/2015,13,30,29,59
42,26/09/2015,14,20,21,41
42,26/09/2015,15,34,34,68
42,26/09/2015,16,37,23,60
42,26/09/2015,17,39,29,68
42,26/09/2015,18,22,25,47
42,26/09/2015,19,24,15,39
42,26/09/2015,20,11,9,20
42,26/09/2015,21,16,7,23
42,26/09/2015,22,12,11,23
42,26/09/2015,23,4,8,12
42,27/09/2015,0,11,9,20
42,27/09/2015,1,4,5,9
42,27/09/2015,2,3,5,8
42,27/09/2015,3,5,1,6
42,27/09/2015,4,3,0,3
42,27/09/2015,5,3,1,4
42,27/09/2015,6,0,0,0
42,27/09/2015,7,3,4,7
42,27/09/2015,8,5,12,17
42,27/09/2015,9,15,34,49
42,27/09/2015,10,26,28,54
42,27/09/2015,11,26,32,58
42,27/09/2015,12,27,29,56
42,27/09/2015,13,37,47,84
42,27/09/2015,14,44,43,87
42,27/09/2015,15,44,52,96
42,27/09/2015,16,56,25,81
42,27/09/2015,17,42,29,71
42,27/09/2015,18,31,29,60
42,27/09/2015,19,12,19,31
42,27/09/2015,20,23,11,34
42,27/09/2015,21,7,4,11
42,27/09/2015,22,14,12,26
42,27/09/2015,23,7,9,16
42,28/09/2015,0,3,1,4
42,28/09/2015,1,0,1,1
42,28/09/2015,2,1,2,3
42,28/09/2015,3,6,0,6
42,28/09/2015,4,0,1,1
42,28/09/2015,5,0,3,3
42,28/09/2015,6,9,10,19
42,28/09/2015,7,11,55,66
42,28/09/2015,8,63,140,203
42,28/09/2015,9,31,109,140
42,28/09/2015,10,15,48,63
42,28/09/2015,11,20,44,64
42,28/09/2015,12,30,31,61
42,28/09/2015,13,37,48,85
42,28/09/2015,14,33,40,73
42,28/09/2015,15,40,40,80
42,28/09/2015,16,71,43,114
42,28/09/2015,17,131,90,221
42,28/09/2015,18,90,57,147
42,28/09/2015,19,59,57,116
42,28/09/2015,20,31,14,45
42,28/09/2015,21,42,15,57
42,28/09/2015,22,12,12,24
42,28/09/2015,23,5,4,9
42,29/09/2015,0,10,1,11
42,29/09/2015,1,1,1,2
42,29/09/2015,2,0,0,0
42,29/09/2015,3,0,0,0
42,29/09/2015,4,0,0,0
42,29/09/2015,5,0,1,1
42,29/09/2015,6,7,14,21
42,29/09/2015,7,15,58,73
42,29/09/2015,8,73,152,225
42,29/09/2015,9,35,96,131
42,29/09/2015,10,17,57,74
42,29/09/2015,11,22,33,55
42,29/09/2015,12,39,47,86
42,29/09/2015,13,40,48,88
42,29/09/2015,14,39,31,70
42,29/09/2015,15,57,47,104
42,29/09/2015,16,84,44,128
42,29/09/2015,17,126,99,225
42,29/09/2015,18,110,73,183
42,29/09/2015,19,68,41,109
42,29/09/2015,20,55,23,78
42,29/09/2015,21,36,16,52
42,29/09/2015,22,18,17,35
42,29/09/2015,23,22,10,32
42,30/09/2015,0,3,3,6
42,30/09/2015,1,2,1,3
42,30/09/2015,2,1,0,1
42,30/09/2015,3,3,1,4
42,30/09/2015,4,0,1,1
42,30/09/2015,5,2,2,4
42,30/09/2015,6,6,11,17
42,30/09/2015,7,25,56,81
42,30/09/2015,8,69,156,225
42,30/09/2015,9,24,98,122
42,30/09/2015,10,20,49,69
42,30/09/2015,11,29,35,64
42,30/09/2015,12,37,39,76
42,30/09/2015,13,35,54,89
42,30/09/2015,14,51,36,87
42,30/09/2015,15,41,51,92
42,30/09/2015,16,90,66,156
42,30/09/2015,17,142,89,231
42,30/09/2015,18,88,66,154
42,30/09/2015,19,78,50,128
42,30/09/2015,20,34,14,48
42,30/09/2015,21,33,17,50
42,30/09/2015,22,22,16,38
42,30/09/2015,23,10,5,15
42,01/10/2015,0,9,4,13
42,01/10/2015,1,1,0,1
42,01/10/2015,2,0,0,0
42,01/10/2015,3,2,1,3
42,01/10/2015,4,0,0,0
42,01/10/2015,5,1,4,5
42,01/10/2015,6,5,12,17
42,01/10/2015,7,22,56,78
42,01/10/2015,8,61,159,220
42,01/10/2015,9,20,115,135
42,01/10/2015,10,14,44,58
42,01/10/2015,11,21,40,61
42,01/10/2015,12,35,44,79
42,01/10/2015,13,53,35,88
42,01/10/2015,14,26,40,66
42,01/10/2015,15,51,40,91
42,01/10/2015,16,92,52,144
42,01/10/2015,17,132,94,226
42,01/10/2015,18,92,54,146
42,01/10/2015,19,55,39,94
42,01/10/2015,20,52,25,77
42,01/10/2015,21,34,15,49
42,01/10/2015,22,19,11,30
42,01/10/2015,23,8,5,13
42,02/10/2015,0,9,5,14
42,02/10/2015,1,3,2,5
42,02/10/2015,2,4,0,4
42,02/10/2015,3,0,0,0
42,02/10/2015,4,0,0,0
42,02/10/2015,5,1,3,4
42,02/10/2015,6,3,15,18
42,02/10/2015,7,17,57,74
42,02/10/2015,8,59,134,193
42,02/10/2015,9,32,96,128
42,02/10/2015,10,16,43,59
42,02/10/2015,11,34,40,74
42,02/10/2015,12,42,40,82
42,02/10/2015,13,48,43,91
42,02/10/2015,14,38,38,76
42,02/10/2015,15,56,36,92
42,02/10/2015,16,81,62,143
42,02/10/2015,17,109,61,170
42,02/10/2015,18,76,48,124
42,02/10/2015,19,39,37,76
42,02/10/2015,20,17,23,40
42,02/10/2015,21,17,11,28
42,02/10/2015,22,20,8,28
42,02/10/2015,23,16,3,19
42,03/10/2015,0,8,3,11
42,03/10/2015,1,2,1,3
42,03/10/2015,2,1,1,2
42,03/10/2015,3,5,0,5
42,03/10/2015,4,2,0,2
42,03/10/2015,5,0,1,1
42,03/10/2015,6,0,6,6
42,03/10/2015,7,4,12,16
42,03/10/2015,8,4,18,22
42,03/10/2015,9,11,31,42
42,03/10/2015,10,23,39,62
42,03/10/2015,11,20,32,52
42,03/10/2015,12,28,36,64
42,03/10/2015,13,29,34,63
42,03/10/2015,14,34,55,89
42,03/10/2015,15,47,38,85
42,03/10/2015,16,35,38,73
42,03/10/2015,17,54,41,95
42,03/10/2015,18,26,19,45
42,03/10/2015,19,17,13,30
42,03/10/2015,20,19,13,32
42,03/10/2015,21,8,15,23
42,03/10/2015,22,11,10,21
42,03/10/2015,23,3,7,10
42,04/10/2015,0,5,7,12
42,04/10/2015,1,3,4,7
42,04/10/2015,2,2,1,3
42,04/10/2015,3,2,0,2
42,04/10/2015,4,1,0,1
42,04/10/2015,5,1,0,1
42,04/10/2015,6,0,2,2
42,04/10/2015,7,4,6,10
42,04/10/2015,8,8,14,22
42,04/10/2015,9,12,23,35
42,04/10/2015,10,22,21,43
42,04/10/2015,11,30,23,53
42,04/10/2015,12,21,33,54
42,04/10/2015,13,25,40,65
42,04/10/2015,14,25,30,55
42,04/10/2015,15,24,23,47
42,04/10/2015,16,31,29,60
42,04/10/2015,17,42,38,80
42,04/10/2015,18,34,28,62
42,04/10/2015,19,29,15,44
42,04/10/2015,20,15,11,26
42,04/10/2015,21,12,10,22
42,04/10/2015,22,8,5,13
42,04/10/2015,23,5,7,12
42,05/10/2015,0,3,4,7
42,05/10/2015,1,1,2,3
42,05/10/2015,2,0,2,2
42,05/10/2015,3,0,0,0
42,05/10/2015,4,0,1,1
42,05/10/2015,5,1,1,2
42,05/10/2015,6,6,11,17
42,05/10/2015,7,17,48,65
42,05/10/2015,8,57,137,194
42,05/10/2015,9,27,127,154
42,05/10/2015,10,18,40,58
42,05/10/2015,11,19,35,54
42,05/10/2015,12,18,27,45
42,05/10/2015,13,29,38,67
42,05/10/2015,14,23,24,47
42,05/10/2015,15,46,37,83
42,05/10/2015,16,76,36,112
42,05/10/2015,17,133,67,200
42,05/10/2015,18,98,52,150
42,05/10/2015,19,48,43,91
42,05/10/2015,20,43,18,61
42,05/10/2015,21,31,19,50
42,05/10/2015,22,7,15,22
42,05/10/2015,23,8,3,11
42,06/10/2015,0,2,2,4
42,06/10/2015,1,1,1,2
42,06/10/2015,2,0,0,0
42,06/10/2015,3,2,1,3
42,06/10/2015,4,0,2,2
42,06/10/2015,5,0,2,2
42,06/10/2015,6,5,13,18
42,06/10/2015,7,19,39,58
42,06/10/2015,8,42,114,156
42,06/10/2015,9,30,105,135
42,06/10/2015,10,13,40,53
42,06/10/2015,11,14,28,42
42,06/10/2015,12,26,33,59
42,06/10/2015,13,25,38,63
42,06/10/2015,14,24,15,39
42,06/10/2015,15,48,29,77
42,06/10/2015,16,70,40,110
42,06/10/2015,17,114,77,191
42,06/10/2015,18,69,57,126
42,06/10/2015,19,62,31,93
42,06/10/2015,20,44,14,58
42,06/10/2015,21,29,12,41
42,06/10/2015,22,18,14,32
42,06/10/2015,23,16,5,21
42,07/10/2015,0,2,0,2
42,07/10/2015,1,0,3,3
42,07/10/2015,2,0,2,2
42,07/10/2015,3,3,0,3
42,07/10/2015,4,0,0,0
42,07/10/2015,5,1,2,3
42,07/10/2015,6,3,15,18
42,07/10/2015,7,12,45,57
42,07/10/2015,8,48,129,177
42,07/10/2015,9,20,105,125
42,07/10/2015,10,12,41,53
42,07/10/2015,11,17,26,43
42,07/10/2015,12,31,25,56
42,07/10/2015,13,28,26,54
42,07/10/2015,14,23,13,36
42,07/10/2015,15,36,17,53
42,07/10/2015,16,60,45,105
42,07/10/2015,17,105,60,165
42,07/10/2015,18,64,38,102
42,07/10/2015,19,44,22,66
42,07/10/2015,20,34,13,47
42,07/10/2015,21,28,5,33
42,07/10/2015,22,24,12,36
42,07/10/2015,23,6,7,13
42,08/10/2015,0,5,2,7
42,08/10/2015,1,0,1,1
42,08/10/2015,2,1,0,1
42,08/10/2015,3,0,0,0
42,08/10/2015,4,0,1,1
42,08/10/2015,5,3,1,4
42,08/10/2015,6,4,13,17
42,08/10/2015,7,27,50,77
42,08/10/2015,8,62,149,211
42,08/10/2015,9,23,94,117
42,08/10/2015,10,14,45,59
42,08/10/2015,11,44,29,73
42,08/10/2015,12,28,30,58
42,08/10/2015,13,34,35,69
42,08/10/2015,14,37,33,70
42,08/10/2015,15,37,24,61
42,08/10/2015,16,86,57,143
42,08/10/2015,17,126,81,207
42,08/10/2015,18,78,77,155
42,08/10/2015,19,59,28,87
42,08/10/2015,20,50,22,72
42,08/10/2015,21,29,21,50
42,08/10/2015,22,29,13,42
42,08/10/2015,23,12,7,19
42,09/10/2015,0,6,2,8
42,09/10/2015,1,4,2,6
42,09/10/2015,2,2,0,2
42,09/10/2015,3,0,0,0
42,09/10/2015,4,0,1,1
42,09/10/2015,5,3,2,5
42,09/10/2015,6,5,14,19
42,09/10/2015,7,16,43,59
42,09/10/2015,8,51,109,160
42,09/10/2015,9,21,84,105
42,09/10/2015,10,15,44,59
42,09/10/2015,11,26,33,59
42,09/10/2015,12,27,39,66
42,09/10/2015,13,46,37,83
42,09/10/2015,14,35,26,61
42,09/10/2015,15,36,33,69
42,09/10/2015,16,73,59,132
42,09/10/2015,17,99,58,157
42,09/10/2015,18,59,47,106
42,09/10/2015,19,42,16,58
42,09/10/2015,20,21,15,36
42,09/10/2015,21,22,11,33
42,09/10/2015,22,7,11,18
42,09/10/2015,23,14,11,25
42,10/10/2015,0,6,6,12
42,10/10/2015,1,4,4,8
42,10/10/2015,2,4,3,7
42,10/10/2015,3,1,1,2
42,10/10/2015,4,3,0,3
42,10/10/2015,5,1,1,2
42,10/10/2015,6,0,2,2
42,10/10/2015,7,2,10,12
42,10/10/2015,8,8,11,19
42,10/10/2015,9,11,26,37
42,10/10/2015,10,23,45,68
42,10/10/2015,11,26,22,48
42,10/10/2015,12,25,37,62
42,10/10/2015,13,31,32,63
42,10/10/2015,14,19,31,50
42,10/10/2015,15,28,36,64
42,10/10/2015,16,39,29,68
42,10/10/2015,17,35,16,51
42,10/10/2015,18,26,20,46
42,10/10/2015,19,20,16,36
42,10/10/2015,20,17,10,27
42,10/10/2015,21,12,9,21
42,10/10/2015,22,10,2,12
42,10/10/2015,23,9,10,19
42,18/10/2015,0,3,5,8
42,18/10/2015,1,1,5,6
42,18/10/2015,2,6,1,7
42,18/10/2015,3,1,0,1
42,18/10/2015,4,2,1,3
42,18/10/2015,5,1,2,3
42,18/10/2015,6,0,2,2
42,18/10/2015,7,2,8,10
42,18/10/2015,8,6,5,11
42,18/10/2015,9,14,24,38
42,18/10/2015,10,21,21,42
42,18/10/2015,11,24,35,59
42,18/10/2015,12,30,26,56
42,18/10/2015,13,32,28,60
42,18/10/2015,14,29,33,62
42,18/10/2015,15,37,47,84
42,18/10/2015,16,24,29,53
42,18/10/2015,17,34,14,48
42,18/10/2015,18,27,29,56
42,18/10/2015,19,34,18,52
42,18/10/2015,20,16,10,26
42,18/10/2015,21,18,6,24
42,18/10/2015,22,6,4,10
42,18/10/2015,23,7,10,17
42,19/10/2015,0,9,3,12
42,19/10/2015,1,2,0,2
42,19/10/2015,2,1,2,3
42,19/10/2015,3,0,1,1
42,19/10/2015,4,0,0,0
42,19/10/2015,5,0,1,1
42,19/10/2015,6,4,14,18
42,19/10/2015,7,21,38,59
42,19/10/2015,8,44,128,172
42,19/10/2015,9,25,107,132
42,19/10/2015,10,13,52,65
42,19/10/2015,11,16,30,46
42,19/10/2015,12,23,22,45
42,19/10/2015,13,22,33,55
42,19/10/2015,14,30,29,59
42,19/10/2015,15,32,23,55
42,19/10/2015,16,69,46,115
42,19/10/2015,17,124,66,190
42,19/10/2015,18,71,41,112
42,19/10/2015,19,64,49,113
42,19/10/2015,20,37,18,55
42,19/10/2015,21,38,9,47
42,19/10/2015,22,28,2,30
42,19/10/2015,23,6,3,9
42,20/10/2015,0,5,2,7
42,20/10/2015,1,1,3,4
42,20/10/2015,2,1,2,3
42,20/10/2015,3,2,0,2
42,20/10/2015,4,0,0,0
42,20/10/2015,5,2,3,5
42,20/10/2015,6,6,9,15
42,20/10/2015,7,21,47,68
42,20/10/2015,8,53,142,195
42,20/10/2015,9,23,104,127
42,20/10/2015,10,14,41,55
42,20/10/2015,11,15,31,46
42,20/10/2015,12,30,27,57
42,20/10/2015,13,40,37,77
42,20/10/2015,14,35,26,61
42,20/10/2015,15,33,40,73
42,20/10/2015,16,77,47,124
42,20/10/2015,17,126,84,210
42,20/10/2015,18,100,49,149
42,20/10/2015,19,50,42,92
42,20/10/2015,20,39,16,55
42,20/10/2015,21,32,14,46
42,20/10/2015,22,24,7,31
42,20/10/2015,23,12,6,18
42,21/10/2015,0,3,2,5
42,21/10/2015,1,5,0,5
42,21/10/2015,2,3,0,3
42,21/10/2015,3,0,2,2
42,21/10/2015,4,2,0,2
42,21/10/2015,5,1,2,3
42,21/10/2015,6,6,12,18
42,21/10/2015,7,14,44,58
42,21/10/2015,8,53,137,190
42,21/10/2015,9,21,108,129
42,21/10/2015,10,11,35,46
42,21/10/2015,11,12,34,46
42,21/10/2015,12,24,33,57
42,21/10/2015,13,37,31,68
42,21/10/2015,14,35,32,67
42,21/10/2015,15,53,18,71
42,21/10/2015,16,56,37,93
42,21/10/2015,17,127,80,207
42,21/10/2015,18,69,46,115
42,21/10/2015,19,48,30,78
42,21/10/2015,20,35,16,51
42,21/10/2015,21,23,12,35
42,21/10/2015,22,31,10,41
42,21/10/2015,23,15,7,22
42,22/10/2015,0,8,2,10
42,22/10/2015,1,5,2,7
42,22/10/2015,2,4,1,5
42,22/10/2015,3,0,1,1
42,22/10/2015,4,0,1,1
42,22/10/2015,5,1,3,4
42,22/10/2015,6,5,9,14
42,22/10/2015,7,17,38,55
42,22/10/2015,8,39,129,168
42,22/10/2015,9,24,84,108
42,22/10/2015,10,24,57,81
42,22/10/2015,11,9,25,34
42,22/10/2015,12,22,28,50
42,22/10/2015,13,28,24,52
42,22/10/2015,14,35,25,60
42,22/10/2015,15,33,20,53
42,22/10/2015,16,65,46,111
42,22/10/2015,17,80,69,149
42,22/10/2015,18,63,39,102
42,22/10/2015,19,46,26,72
42,22/10/2015,20,44,12,56
42,22/10/2015,21,40,12,52
42,22/10/2015,22,30,12,42
42,22/10/2015,23,12,7,19
42,23/10/2015,0,10,0,10
42,23/10/2015,1,4,3,7
42,23/10/2015,2,2,0,2
42,23/10/2015,3,0,0,0
42,23/10/2015,4,1,0,1
42,23/10/2015,5,1,2,3
42,23/10/2015,6,3,15,18
42,23/10/2015,7,18,42,60
42,23/10/2015,8,40,95,135
42,23/10/2015,9,20,75,95
42,23/10/2015,10,15,45,60
42,23/10/2015,11,17,32,49
42,23/10/2015,12,21,23,44
42,23/10/2015,13,43,44,87
42,23/10/2015,14,27,24,51
42,23/10/2015,15,44,40,84
42,23/10/2015,16,54,47,101
42,23/10/2015,17,85,66,151
42,23/10/2015,18,47,37,84
42,23/10/2015,19,48,20,68
42,23/10/2015,20,22,13,35
42,23/10/2015,21,15,12,27
42,23/10/2015,22,23,11,34
42,23/10/2015,23,12,6,18
42,24/10/2015,0,5,6,11
42,24/10/2015,1,11,5,16
42,24/10/2015,2,2,2,4
42,24/10/2015,3,5,0,5
42,24/10/2015,4,0,1,1
42,24/10/2015,5,0,0,0
42,24/10/2015,6,0,1,1
42,24/10/2015,7,3,8,11
42,24/10/2015,8,5,13,18
42,24/10/2015,9,3,17,20
42,24/10/2015,10,12,19,31
42,24/10/2015,11,11,18,29
42,24/10/2015,12,17,25,42
42,24/10/2015,13,17,22,39
42,24/10/2015,14,27,28,55
42,24/10/2015,15,29,30,59
42,24/10/2015,16,38,24,62
42,24/10/2015,17,33,27,60
42,24/10/2015,18,17,22,39
42,24/10/2015,19,19,21,40
42,24/10/2015,20,16,8,24
42,24/10/2015,21,19,14,33
42,24/10/2015,22,7,9,16
42,24/10/2015,23,6,14,20
42,25/10/2015,0,9,1,10
42,25/10/2015,1,4,1,5
42,25/10/2015,2,2,4,6
42,25/10/2015,3,4,3,7
42,25/10/2015,4,2,1,3
42,25/10/2015,5,0,1,1
42,25/10/2015,6,0,3,3
42,25/10/2015,7,2,8,10
42,25/10/2015,8,7,19,26
42,25/10/2015,9,21,41,62
42,25/10/2015,10,30,32,62
42,25/10/2015,11,31,33,64
42,25/10/2015,12,20,32,52
42,25/10/2015,13,25,39,64
42,25/10/2015,14,38,41,79
42,25/10/2015,15,51,40,91
42,25/10/2015,16,36,28,64
42,25/10/2015,17,19,16,35
42,25/10/2015,18,18,21,39
42,25/10/2015,19,36,17,53
42,25/10/2015,20,18,16,34
42,25/10/2015,21,18,6,24
42,25/10/2015,22,14,8,22
42,25/10/2015,23,5,11,16
42,26/10/2015,0,5,5,10
42,26/10/2015,1,2,0,2
42,26/10/2015,2,0,0,0
42,26/10/2015,3,1,1,2
42,26/10/2015,4,0,0,0
42,26/10/2015,5,1,1,2
42,26/10/2015,6,7,13,20
42,26/10/2015,7,20,51,71
42,26/10/2015,8,47,149,196
42,26/10/2015,9,31,113,144
42,26/10/2015,10,20,46,66
42,26/10/2015,11,21,37,58
42,26/10/2015,12,28,33,61
42,26/10/2015,13,31,33,64
42,26/10/2015,14,30,16,46
42,26/10/2015,15,46,26,72
42,26/10/2015,16,71,45,116
42,26/10/2015,17,137,89,226
42,26/10/2015,18,81,34,115
42,26/10/2015,19,57,27,84
42,26/10/2015,20,42,12,54
42,26/10/2015,21,31,16,47
42,26/10/2015,22,18,16,34
42,26/10/2015,23,12,7,19
42,27/10/2015,0,6,0,6
42,27/10/2015,1,1,0,1
42,27/10/2015,2,1,1,2
42,27/10/2015,3,1,0,1
42,27/10/2015,4,0,0,0
42,27/10/2015,5,2,3,5
42,27/10/2015,6,10,10,20
42,27/10/2015,7,24,50,74
42,27/10/2015,8,47,147,194
42,27/10/2015,9,31,112,143
42,27/10/2015,10,13,54,67
42,27/10/2015,11,21,33,54
42,27/10/2015,12,20,17,37
42,27/10/2015,13,46,44,90
42,27/10/2015,14,40,34,74
42,27/10/2015,15,36,30,66
42,27/10/2015,16,86,52,138
42,27/10/2015,17,120,63,183
42,27/10/2015,18,83,52,135
42,27/10/2015,19,48,24,72
42,27/10/2015,20,53,11,64
42,27/10/2015,21,43,12,55
42,27/10/2015,22,18,20,38
42,27/10/2015,23,24,9,33
42,28/10/2015,0,7,5,12
42,28/10/2015,1,3,0,3
42,28/10/2015,2,0,0,0
42,28/10/2015,3,2,0,2
42,28/10/2015,4,0,1,1
42,28/10/2015,5,1,2,3
42,28/10/2015,6,3,9,12
42,28/10/2015,7,22,55,77
42,28/10/2015,8,58,134,192
42,28/10/2015,9,26,118,144
42,28/10/2015,10,19,48,67
42,28/10/2015,11,20,30,50
42,28/10/2015,12,25,34,59
42,28/10/2015,13,45,31,76
42,28/10/2015,14,32,24,56
42,28/10/2015,15,30,28,58
42,28/10/2015,16,63,27,90
42,28/10/2015,17,95,57,152
42,28/10/2015,18,70,45,115
42,28/10/2015,19,46,28,74
42,28/10/2015,20,29,20,49
42,28/10/2015,21,37,14,51
42,28/10/2015,22,18,9,27
42,28/10/2015,23,11,7,18
42,29/10/2015,0,6,10,16
42,29/10/2015,1,4,1,5
42,29/10/2015,2,1,1,2
42,29/10/2015,3,0,0,0
42,29/10/2015,4,2,0,2
42,29/10/2015,5,0,2,2
42,29/10/2015,6,10,11,21
42,29/10/2015,7,21,45,66
42,29/10/2015,8,45,142,187
42,29/10/2015,9,24,90,114
42,29/10/2015,10,20,45,65
42,29/10/2015,11,22,31,53
42,29/10/2015,12,16,22,38
42,29/10/2015,13,27,28,55
42,29/10/2015,14,32,31,63
42,29/10/2015,15,40,31,71
42,29/10/2015,16,66,49,115
42,29/10/2015,17,107,60,167
42,29/10/2015,18,77,39,116
42,29/10/2015,19,54,24,78
42,29/10/2015,20,45,19,64
42,29/10/2015,21,28,21,49
42,29/10/2015,22,23,4,27
42,29/10/2015,23,23,11,34
42,30/10/2015,0,14,8,22
42,30/10/2015,1,5,0,5
42,30/10/2015,2,1,2,3
42,30/10/2015,3,2,2,4
42,30/10/2015,4,0,0,0
42,30/10/2015,5,1,2,3
42,30/10/2015,6,6,14,20
42,30/10/2015,7,19,50,69
42,30/10/2015,8,49,105,154
42,30/10/2015,9,23,77,100
42,30/10/2015,10,13,44,57
42,30/10/2015,11,15,32,47
42,30/10/2015,12,27,31,58
42,30/10/2015,13,37,35,72
42,30/10/2015,14,32,36,68
42,30/10/2015,15,37,32,69
42,30/10/2015,16,57,50,107
42,30/10/2015,17,73,54,127
42,30/10/2015,18,50,38,88
42,30/10/2015,19,40,30,70
42,30/10/2015,20,28,21,49
42,30/10/2015,21,13,10,23
42,30/10/2015,22,16,9,25
42,30/10/2015,23,6,5,11
42,31/10/2015,0,7,7,14
42,31/10/2015,1,2,6,8
42,31/10/2015,2,1,2,3
42,31/10/2015,3,1,0,1
42,31/10/2015,4,0,1,1
42,31/10/2015,5,1,2,3
42,31/10/2015,6,1,0,1
42,31/10/2015,7,2,12,14
42,31/10/2015,8,4,12,16
42,31/10/2015,9,17,27,44
42,31/10/2015,10,21,30,51
42,31/10/2015,11,19,33,52
42,31/10/2015,12,27,24,51
42,31/10/2015,13,30,24,54
42,31/10/2015,14,32,40,72
42,31/10/2015,15,25,41,66
42,31/10/2015,16,31,20,51
42,31/10/2015,17,29,14,43
42,31/10/2015,18,28,22,50
42,31/10/2015,19,21,12,33
42,31/10/2015,20,21,18,39
42,31/10/2015,21,17,11,28
42,31/10/2015,22,6,4,10
42,31/10/2015,23,6,6,12
42,01/11/2015,0,8,4,12
42,01/11/2015,1,5,1,6
42,01/11/2015,2,5,3,8
42,01/11/2015,3,5,3,8
42,01/11/2015,4,1,0,1
42,01/11/2015,5,0,3,3
42,01/11/2015,6,1,0,1
42,01/11/2015,7,4,5,9
42,01/11/2015,8,8,10,18
42,01/11/2015,9,7,25,32
42,01/11/2015,10,16,45,61
42,01/11/2015,11,21,21,42
42,01/11/2015,12,27,41,68
42,01/11/2015,13,39,44,83
42,01/11/2015,14,35,25,60
42,01/11/2015,15,31,32,63
42,01/11/2015,16,32,34,66
42,01/11/2015,17,35,21,56
42,01/11/2015,18,31,15,46
42,01/11/2015,19,16,8,24
42,01/11/2015,20,24,12,36
42,01/11/2015,21,13,5,18
42,01/11/2015,22,12,10,22
42,01/11/2015,23,10,6,16
42,02/11/2015,0,7,4,11
42,02/11/2015,1,5,0,5
42,02/11/2015,2,1,0,1
42,02/11/2015,3,1,0,1
42,02/11/2015,4,0,0,0
42,02/11/2015,5,0,2,2
42,02/11/2015,6,8,11,19
42,02/11/2015,7,17,44,61
42,02/11/2015,8,54,137,191
42,02/11/2015,9,24,122,146
42,02/11/2015,10,17,45,62
42,02/11/2015,11,16,26,42
42,02/11/2015,12,30,35,65
42,02/11/2015,13,27,39,66
42,02/11/2015,14,41,25,66
42,02/11/2015,15,42,31,73
42,02/11/2015,16,79,48,127
42,02/11/2015,17,112,71,183
42,02/11/2015,18,70,54,124
42,02/11/2015,19,37,33,70
42,02/11/2015,20,41,24,65
42,02/11/2015,21,36,9,45
42,02/11/2015,22,15,7,22
42,02/11/2015,23,10,7,17
42,03/11/2015,0,6,2,8
42,03/11/2015,1,2,1,3
42,03/11/2015,2,0,2,2
42,03/11/2015,3,0,0,0
42,03/11/2015,4,0,0,0
42,03/11/2015,5,1,4,5
42,03/11/2015,6,8,7,15
42,03/11/2015,7,22,62,84
42,03/11/2015,8,56,158,214
42,03/11/2015,9,22,127,149
42,03/11/2015,10,19,39,58
42,03/11/2015,11,32,37,69
42,03/11/2015,12,19,35,54
42,03/11/2015,13,32,37,69
42,03/11/2015,14,35,32,67
42,03/11/2015,15,56,27,83
42,03/11/2015,16,75,35,110
42,03/11/2015,17,129,85,214
42,03/11/2015,18,83,50,133
42,03/11/2015,19,58,37,95
42,03/11/2015,20,47,23,70
42,03/11/2015,21,32,17,49
42,03/11/2015,22,24,7,31
42,03/11/2015,23,7,11,18
42,04/11/2015,0,3,7,10
42,04/11/2015,1,6,0,6
42,04/11/2015,2,2,0,2
42,04/11/2015,3,0,0,0
42,04/11/2015,4,0,0,0
42,04/11/2015,5,1,3,4
42,04/11/2015,6,4,10,14
42,04/11/2015,7,11,45,56
42,04/11/2015,8,35,115,150
42,04/11/2015,9,25,108,133
42,04/11/2015,10,24,55,79
42,04/11/2015,11,15,31,46
42,04/11/2015,12,19,33,52
42,04/11/2015,13,31,27,58
42,04/11/2015,14,20,23,43
42,04/11/2015,15,31,28,59
42,04/11/2015,16,55,35,90
42,04/11/2015,17,109,57,166
42,04/11/2015,18,59,43,102
42,04/11/2015,19,51,24,75
42,04/11/2015,20,32,11,43
42,04/11/2015,21,29,11,40
42,04/11/2015,22,25,9,34
42,04/11/2015,23,11,9,20
42,05/11/2015,0,9,6,15
42,05/11/2015,1,2,1,3
42,05/11/2015,2,1,0,1
42,05/11/2015,3,1,0,1
42,05/11/2015,4,0,0,0
42,05/11/2015,5,1,2,3
42,05/11/2015,6,4,9,13
42,05/11/2015,7,22,53,75
42,05/11/2015,8,43,139,182
42,05/11/2015,9,26,111,137
42,05/11/2015,10,16,46,62
42,05/11/2015,11,15,29,44
42,05/11/2015,12,39,31,70
42,05/11/2015,13,35,43,78
42,05/11/2015,14,31,29,60
42,05/11/2015,15,36,23,59
42,05/11/2015,16,75,47,122
42,05/11/2015,17,109,61,170
42,05/11/2015,18,76,51,127
42,05/11/2015,19,46,25,71
42,05/11/2015,20,35,8,43
42,05/11/2015,21,33,10,43
42,05/11/2015,22,13,11,24
42,05/11/2015,23,18,9,27
42,06/11/2015,0,4,3,7
42,06/11/2015,1,3,2,5
42,06/11/2015,2,1,0,1
42,06/11/2015,3,0,0,0
42,06/11/2015,4,1,0,1
42,06/11/2015,5,1,1,2
42,06/11/2015,6,4,13,17
42,06/11/2015,7,13,44,57
42,06/11/2015,8,41,90,131
42,06/11/2015,9,16,80,96
42,06/11/2015,10,18,49,67
42,06/11/2015,11,21,29,50
42,06/11/2015,12,27,24,51
42,06/11/2015,13,23,34,57
42,06/11/2015,14,22,35,57
42,06/11/2015,15,45,36,81
42,06/11/2015,16,70,26,96
42,06/11/2015,17,80,46,126
42,06/11/2015,18,55,32,87
42,06/11/2015,19,38,26,64
42,06/11/2015,20,25,15,40
42,06/11/2015,21,27,17,44
42,06/11/2015,22,15,12,27
42,06/11/2015,23,13,8,21
42,07/11/2015,0,6,3,9
42,07/11/2015,1,4,2,6
42,07/11/2015,2,1,0,1
42,07/11/2015,3,2,0,2
42,07/11/2015,4,2,3,5
42,07/11/2015,5,2,0,2
42,07/11/2015,6,1,2,3
42,07/11/2015,7,5,5,10
42,07/11/2015,8,7,12,19
42,07/11/2015,9,5,14,19
42,07/11/2015,10,6,20,26
42,07/11/2015,11,6,20,26
42,07/11/2015,12,17,19,36
42,07/11/2015,13,19,12,31
42,07/11/2015,14,8,14,22
42,07/11/2015,15,19,22,41
42,07/11/2015,16,13,31,44
42,07/11/2015,17,26,18,44
42,07/11/2015,18,19,14,33
42,07/11/2015,19,13,9,22
42,07/11/2015,20,13,6,19
42,07/11/2015,21,14,8,22
42,07/11/2015,22,11,7,18
42,07/11/2015,23,11,9,20
42,08/11/2015,0,6,5,11
42,08/11/2015,1,4,4,8
42,08/11/2015,2,2,5,7
42,08/11/2015,3,2,1,3
42,08/11/2015,4,1,0,1
42,08/11/2015,5,3,3,6
42,08/11/2015,6,9,4,13
42,08/11/2015,7,7,5,12
42,08/11/2015,8,4,9,13
42,08/11/2015,9,11,19,30
42,08/11/2015,10,10,28,38
42,08/11/2015,11,22,34,56
42,08/11/2015,12,19,20,39
42,08/11/2015,13,21,21,42
42,08/11/2015,14,21,21,42
42,08/11/2015,15,22,7,29
42,08/11/2015,16,13,8,21
42,08/11/2015,17,19,14,33
42,08/11/2015,18,14,17,31
42,08/11/2015,19,10,3,13
42,08/11/2015,20,11,10,21
42,08/11/2015,21,8,2,10
42,08/11/2015,22,8,5,13
42,08/11/2015,23,7,2,9
42,09/11/2015,0,6,3,9
42,09/11/2015,1,2,0,2
42,09/11/2015,2,0,0,0
42,09/11/2015,3,0,1,1
42,09/11/2015,4,0,0,0
42,09/11/2015,5,0,0,0
42,09/11/2015,6,2,9,11
42,09/11/2015,7,12,24,36
42,09/11/2015,8,28,89,117
42,09/11/2015,9,16,78,94
42,09/11/2015,10,12,26,38
42,09/11/2015,11,7,19,26
42,09/11/2015,12,18,27,45
42,09/11/2015,13,17,20,37
42,09/11/2015,14,20,19,39
42,09/11/2015,15,22,18,40
42,09/11/2015,16,50,25,75
42,09/11/2015,17,82,43,125
42,09/11/2015,18,58,36,94
42,09/11/2015,19,43,17,60
42,09/11/2015,20,24,13,37
42,09/11/2015,21,23,12,35
42,09/11/2015,22,23,7,30
42,09/11/2015,23,9,6,15
42,10/11/2015,0,3,1,4
42,10/11/2015,1,1,0,1
42,10/11/2015,2,0,0,0
42,10/11/2015,3,0,1,1
42,10/11/2015,4,0,0,0
42,10/11/2015,5,0,1,1
42,10/11/2015,6,4,12,16
42,10/11/2015,7,18,36,54
42,10/11/2015,8,34,103,137
42,10/11/2015,9,13,92,105
42,10/11/2015,10,15,47,62
42,10/11/2015,11,13,23,36
42,10/11/2015,12,22,24,46
42,10/11/2015,13,34,26,60
42,10/11/2015,14,19,18,37
42,10/11/2015,15,32,28,60
42,10/11/2015,16,45,29,74
42,10/11/2015,17,84,52,136
42,10/11/2015,18,63,46,109
42,10/11/2015,19,49,17,66
42,10/11/2015,20,34,12,46
42,10/11/2015,21,25,12,37
42,10/11/2015,22,16,7,23
42,10/11/2015,23,11,7,18
42,11/11/2015,0,3,3,6
42,11/11/2015,1,1,2,3
42,11/11/2015,2,4,0,4
42,11/11/2015,3,0,0,0
42,11/11/2015,4,0,0,0
42,11/11/2015,5,2,1,3
42,11/11/2015,6,6,9,15
42,11/11/2015,7,26,44,70
42,11/11/2015,8,40,126,166
42,11/11/2015,9,20,100,120
42,11/11/2015,10,15,47,62
42,11/11/2015,11,23,37,60
42,11/11/2015,12,15,35,50
42,11/11/2015,13,37,33,70
42,11/11/2015,14,28,26,54
42,11/11/2015,15,35,30,65
42,11/11/2015,16,66,38,104
42,11/11/2015,17,110,55,165
42,11/11/2015,18,59,54,113
42,11/11/2015,19,36,28,64
42,11/11/2015,20,34,8,42
42,11/11/2015,21,31,10,41
42,11/11/2015,22,28,11,39
42,11/11/2015,23,9,15,24
42,12/11/2015,0,8,1,9
42,12/11/2015,1,4,0,4
42,12/11/2015,2,2,1,3
42,12/11/2015,3,1,0,1
42,12/11/2015,4,0,0,0
42,12/11/2015,5,1,1,2
42,12/11/2015,6,4,12,16
42,12/11/2015,7,16,38,54
42,12/11/2015,8,42,115,157
42,12/11/2015,9,20,108,128
42,12/11/2015,10,21,49,70
42,12/11/2015,11,18,41,59
42,12/11/2015,12,34,26,60
42,12/11/2015,13,29,33,62
42,12/11/2015,14,34,30,64
42,12/11/2015,15,31,18,49
42,12/11/2015,16,48,21,69
42,12/11/2015,17,87,62,149
42,12/11/2015,18,67,25,92
42,12/11/2015,19,37,15,52
42,12/11/2015,20,26,11,37
42,12/11/2015,21,23,8,31
42,12/11/2015,22,15,9,24
42,12/11/2015,23,10,5,15
42,13/11/2015,0,8,8,16
42,13/11/2015,1,1,1,2
42,13/11/2015,2,2,0,2
42,13/11/2015,3,0,0,0
42,13/11/2015,4,0,0,0
42,13/11/2015,5,1,0,1
42,13/11/2015,6,2,6,8
42,13/11/2015,7,8,26,34
42,13/11/2015,8,28,82,110
42,13/11/2015,9,14,61,75
42,13/11/2015,10,10,28,38
42,13/11/2015,11,7,24,31
42,13/11/2015,12,19,16,35
42,13/11/2015,13,29,22,51
42,13/11/2015,14,23,19,42
42,13/11/2015,15,19,30,49
42,13/11/2015,16,41,17,58
42,13/11/2015,17,60,32,92
42,13/11/2015,18,28,23,51
42,13/11/2015,19,20,12,32
42,13/11/2015,20,12,5,17
42,13/11/2015,21,16,11,27
42,13/11/2015,22,7,2,9
42,13/11/2015,23,7,4,11
42,14/11/2015,0,5,2,7
42,14/11/2015,1,3,1,4
42,14/11/2015,2,3,0,3
42,14/11/2015,3,2,0,2
42,14/11/2015,4,1,0,1
42,14/11/2015,5,0,1,1
42,14/11/2015,6,0,1,1
42,14/11/2015,7,6,0,6
42,14/11/2015,8,1,6,7
42,14/11/2015,9,8,8,16
42,14/11/2015,10,14,35,49
42,14/11/2015,11,15,23,38
42,14/11/2015,12,20,23,43
42,14/11/2015,13,15,26,41
42,14/11/2015,14,19,36,55
42,14/11/2015,15,19,28,47
42,14/11/2015,16,31,16,47
42,14/11/2015,17,18,18,36
42,14/11/2015,18,12,12,24
42,14/11/2015,19,17,8,25
42,14/11/2015,20,7,1,8
42,14/11/2015,21,5,9,14
42,14/11/2015,22,2,1,3
42,14/11/2015,23,5,8,13
42,15/11/2015,0,3,2,5
42,15/11/2015,1,4,0,4
42,15/11/2015,2,4,0,4
42,15/11/2015,3,0,3,3
42,15/11/2015,4,1,0,1
42,15/11/2015,5,0,2,2
42,15/11/2015,6,1,1,2
42,15/11/2015,7,5,2,7
42,15/11/2015,8,3,4,7
42,15/11/2015,9,9,18,27
42,15/11/2015,10,25,23,48
42,15/11/2015,11,11,17,28
42,15/11/2015,12,16,16,32
42,15/11/2015,13,13,11,24
42,15/11/2015,14,21,15,36
42,15/11/2015,15,8,17,25
42,15/11/2015,16,12,16,28
42,15/11/2015,17,17,10,27
42,15/11/2015,18,10,8,18
42,15/11/2015,19,13,15,28
42,15/11/2015,20,10,7,17
42,15/11/2015,21,7,3,10
42,15/11/2015,22,13,3,16
42,15/11/2015,23,7,2,9
42,16/11/2015,0,5,3,8
42,16/11/2015,1,1,0,1
42,16/11/2015,2,1,0,1
42,16/11/2015,3,0,0,0
42,16/11/2015,4,0,0,0
42,16/11/2015,5,1,0,1
42,16/11/2015,6,3,4,7
42,16/11/2015,7,13,39,52
42,16/11/2015,8,36,115,151
42,16/11/2015,9,27,80,107
42,16/11/2015,10,7,36,43
42,16/11/2015,11,14,29,43
42,16/11/2015,12,20,26,46
42,16/11/2015,13,18,29,47
42,16/11/2015,14,25,28,53
42,16/11/2015,15,34,34,68
42,16/11/2015,16,56,21,77
42,16/11/2015,17,93,47,140
42,16/11/2015,18,54,27,81
42,16/11/2015,19,46,26,72
42,16/11/2015,20,31,12,43
42,16/11/2015,21,31,8,39
42,16/11/2015,22,17,10,27
42,16/11/2015,23,10,2,12
42,17/11/2015,0,2,4,6
42,17/11/2015,1,1,0,1
42,17/11/2015,2,1,0,1
42,17/11/2015,3,0,0,0
42,17/11/2015,4,0,0,0
42,17/11/2015,5,2,2,4
42,17/11/2015,6,5,9,14
42,17/11/2015,7,18,40,58
42,17/11/2015,8,37,126,163
42,17/11/2015,9,16,101,117
42,17/11/2015,10,17,49,66
42,17/11/2015,11,13,35,48
42,17/11/2015,12,29,23,52
42,17/11/2015,13,17,25,42
42,17/11/2015,14,18,14,32
42,17/11/2015,15,35,20,55
42,17/11/2015,16,51,29,80
42,17/11/2015,17,92,43,135
42,17/11/2015,18,69,42,111
42,17/11/2015,19,42,14,56
42,17/11/2015,20,29,10,39
42,17/11/2015,21,21,13,34
42,17/11/2015,22,19,3,22
42,17/11/2015,23,8,3,11
42,18/11/2015,0,6,1,7
42,18/11/2015,1,3,1,4
42,18/11/2015,2,1,2,3
42,18/11/2015,3,0,2,2
42,18/11/2015,4,0,1,1
42,18/11/2015,5,0,1,1
42,18/11/2015,6,5,7,12
42,18/11/2015,7,19,43,62
42,18/11/2015,8,29,90,119
42,18/11/2015,9,14,90,104
42,18/11/2015,10,14,42,56
42,18/11/2015,11,8,21,29
42,18/11/2015,12,19,17,36
42,18/11/2015,13,23,19,42
42,18/11/2015,14,22,17,39
42,18/11/2015,15,22,20,42
42,18/11/2015,16,57,37,94
42,18/11/2015,17,86,50,136
42,18/11/2015,18,52,30,82
42,18/11/2015,19,43,18,61
42,18/11/2015,20,26,10,36
42,18/11/2015,21,26,9,35
42,18/11/2015,22,19,8,27
42,18/11/2015,23,11,5,16
42,19/11/2015,0,2,0,2
42,19/11/2015,1,2,1,3
42,19/11/2015,2,3,1,4
42,19/11/2015,3,2,0,2
42,19/11/2015,4,0,0,0
42,19/11/2015,5,1,2,3
42,19/11/2015,6,4,6,10
42,19/11/2015,7,17,43,60
42,19/11/2015,8,31,113,144
42,19/11/2015,9,27,102,129
42,19/11/2015,10,17,29,46
42,19/11/2015,11,18,28,46
42,19/11/2015,12,27,26,53
42,19/11/2015,13,24,38,62
42,19/11/2015,14,27,23,50
42,19/11/2015,15,37,31,68
42,19/11/2015,16,69,39,108
42,19/11/2015,17,89,50,139
42,19/11/2015,18,64,36,100
42,19/11/2015,19,37,21,58
42,19/11/2015,20,34,10,44
42,19/11/2015,21,27,14,41
42,19/11/2015,22,17,6,23
42,19/11/2015,23,14,4,18
42,20/11/2015,0,11,3,14
42,20/11/2015,1,0,4,4
42,20/11/2015,2,3,2,5
42,20/11/2015,3,1,0,1
42,20/11/2015,4,1,0,1
42,20/11/2015,5,2,2,4
42,20/11/2015,6,5,9,14
42,20/11/2015,7,11,31,42
42,20/11/2015,8,25,86,111
42,20/11/2015,9,21,63,84
42,20/11/2015,10,16,25,41
42,20/11/2015,11,18,29,47
42,20/11/2015,12,22,29,51
42,20/11/2015,13,31,22,53
42,20/11/2015,14,34,19,53
42,20/11/2015,15,26,21,47
42,20/11/2015,16,52,26,78
42,20/11/2015,17,63,41,104
42,20/11/2015,18,40,27,67
42,20/11/2015,19,31,30,61
42,20/11/2015,20,19,12,31
42,20/11/2015,21,8,12,20
42,20/11/2015,22,19,6,25
42,20/11/2015,23,17,5,22
42,21/11/2015,0,4,5,9
42,21/11/2015,1,6,2,8
42,21/11/2015,2,1,1,2
42,21/11/2015,3,3,0,3
42,21/11/2015,4,2,0,2
42,21/11/2015,5,0,0,0
42,21/11/2015,6,0,1,1
42,21/11/2015,7,2,4,6
42,21/11/2015,8,5,6,11
42,21/11/2015,9,9,13,22
42,21/11/2015,10,12,33,45
42,21/11/2015,11,15,16,31
42,21/11/2015,12,14,24,38
42,21/11/2015,13,25,23,48
42,21/11/2015,14,16,16,32
42,21/11/2015,15,25,21,46
42,21/11/2015,16,20,15,35
42,21/11/2015,17,18,14,32
42,21/11/2015,18,14,14,28
42,21/11/2015,19,9,14,23
42,21/11/2015,20,13,5,18
42,21/11/2015,21,8,5,13
42,21/11/2015,22,6,2,8
42,21/11/2015,23,4,6,10
42,22/11/2015,0,7,6,13
42,22/11/2015,1,9,2,11
42,22/11/2015,2,0,0,0
42,22/11/2015,3,1,3,4
42,22/11/2015,4,3,0,3
42,22/11/2015,5,2,0,2
42,22/11/2015,6,2,2,4
42,22/11/2015,7,3,1,4
42,22/11/2015,8,6,7,13
42,22/11/2015,9,9,14,23
42,22/11/2015,10,10,25,35
42,22/11/2015,11,11,28,39
42,22/11/2015,12,22,27,49
42,22/11/2015,13,28,32,60
42,22/11/2015,14,23,27,50
42,22/11/2015,15,22,30,52
42,22/11/2015,16,24,24,48
42,22/11/2015,17,19,13,32
42,22/11/2015,18,19,14,33
42,22/11/2015,19,17,10,27
42,22/11/2015,20,13,6,19
42,22/11/2015,21,12,3,15
42,22/11/2015,22,9,8,17
42,22/11/2015,23,8,4,12
42,23/11/2015,0,7,1,8
42,23/11/2015,1,1,1,2
42,23/11/2015,2,1,0,1
42,23/11/2015,3,0,0,0
42,23/11/2015,4,0,0,0
42,23/11/2015,5,2,2,4
42,23/11/2015,6,4,11,15
42,23/11/2015,7,14,42,56
42,23/11/2015,8,41,115,156
42,23/11/2015,9,23,95,118
42,23/11/2015,10,10,45,55
42,23/11/2015,11,7,23,30
42,23/11/2015,12,12,23,35
42,23/11/2015,13,17,15,32
42,23/11/2015,14,23,24,47
42,23/11/2015,15,21,22,43
42,23/11/2015,16,43,28,71
42,23/11/2015,17,105,57,162
42,23/11/2015,18,64,33,97
42,23/11/2015,19,40,20,60
42,23/11/2015,20,34,10,44
42,23/11/2015,21,34,16,50
42,23/11/2015,22,20,7,27
42,23/11/2015,23,8,6,14
42,24/11/2015,0,9,4,13
42,24/11/2015,1,2,0,2
42,24/11/2015,2,3,0,3
42,24/11/2015,3,0,0,0
42,24/11/2015,4,0,0,0
42,24/11/2015,5,0,2,2
42,24/11/2015,6,9,9,18
42,24/11/2015,7,17,47,64
42,24/11/2015,8,51,123,174
42,24/11/2015,9,16,108,124
42,24/11/2015,10,16,46,62
42,24/11/2015,11,19,31,50
42,24/11/2015,12,24,30,54
42,24/11/2015,13,22,21,43
42,24/11/2015,14,30,32,62
42,24/11/2015,15,37,23,60
42,24/11/2015,16,61,43,104
42,24/11/2015,17,96,60,156
42,24/11/2015,18,73,51,124
42,24/11/2015,19,38,28,66
42,24/11/2015,20,42,9,51
42,24/11/2015,21,36,10,46
42,24/11/2015,22,16,6,22
42,24/11/2015,23,16,9,25
42,25/11/2015,0,5,2,7
42,25/11/2015,1,2,0,2
42,25/11/2015,2,3,0,3
42,25/11/2015,3,0,0,0
42,25/11/2015,4,5,0,5
42,25/11/2015,5,0,3,3
42,25/11/2015,6,6,10,16
42,25/11/2015,7,28,55,83
42,25/11/2015,8,45,116,161
42,25/11/2015,9,16,97,113
42,25/11/2015,10,17,41,58
42,25/11/2015,11,14,23,37
42,25/11/2015,12,12,32,44
42,25/11/2015,13,25,25,50
42,25/11/2015,14,39,36,75
42,25/11/2015,15,50,21,71
42,25/11/2015,16,63,43,106
42,25/11/2015,17,100,48,148
42,25/11/2015,18,77,44,121
42,25/11/2015,19,41,35,76
42,25/11/2015,20,30,12,42
42,25/11/2015,21,37,16,53
42,25/11/2015,22,22,5,27
42,25/11/2015,23,12,9,21
42,26/11/2015,0,6,3,9
42,26/11/2015,1,1,2,3
42,26/11/2015,2,1,0,1
42,26/11/2015,3,1,0,1
42,26/11/2015,4,0,0,0
42,26/11/2015,5,0,1,1
42,26/11/2015,6,6,9,15
42,26/11/2015,7,16,45,61
42,26/11/2015,8,50,127,177
42,26/11/2015,9,23,85,108
42,26/11/2015,10,18,43,61
42,26/11/2015,11,23,29,52
42,26/11/2015,12,25,23,48
42,26/11/2015,13,28,39,67
42,26/11/2015,14,27,19,46
42,26/11/2015,15,39,30,69
42,26/11/2015,16,64,36,100
42,26/11/2015,17,106,54,160
42,26/11/2015,18,60,43,103
42,26/11/2015,19,38,19,57
42,26/11/2015,20,32,15,47
42,26/11/2015,21,26,19,45
42,26/11/2015,22,19,5,24
42,26/11/2015,23,11,4,15
42,27/11/2015,0,7,3,10
42,27/11/2015,1,6,2,8
42,27/11/2015,2,3,1,4
42,27/11/2015,3,0,0,0
42,27/11/2015,4,1,0,1
42,27/11/2015,5,0,0,0
42,27/11/2015,6,2,12,14
42,27/11/2015,7,11,31,42
42,27/11/2015,8,30,95,125
42,27/11/2015,9,16,54,70
42,27/11/2015,10,16,36,52
42,27/11/2015,11,18,21,39
42,27/11/2015,12,26,22,48
42,27/11/2015,13,22,23,45
42,27/11/2015,14,13,15,28
42,27/11/2015,15,23,18,41
42,27/11/2015,16,32,20,52
42,27/11/2015,17,67,35,102
42,27/11/2015,18,34,21,55
42,27/11/2015,19,17,16,33
42,27/11/2015,20,20,7,27
42,27/11/2015,21,14,8,22
42,27/11/2015,22,19,7,26
42,27/11/2015,23,9,4,13
42,28/11/2015,0,6,4,10
42,28/11/2015,1,5,1,6
42,28/11/2015,2,2,1,3
42,28/11/2015,3,0,2,2
42,28/11/2015,4,4,0,4
42,28/11/2015,5,3,0,3
42,28/11/2015,6,1,0,1
42,28/11/2015,7,5,3,8
42,28/11/2015,8,5,10,15
42,28/11/2015,9,9,16,25
42,28/11/2015,10,11,18,29
42,28/11/2015,11,11,19,30
42,28/11/2015,12,15,38,53
42,28/11/2015,13,22,14,36
42,28/11/2015,14,17,11,28
42,28/11/2015,15,27,19,46
42,28/11/2015,16,16,7,23
42,28/11/2015,17,19,14,33
42,28/11/2015,18,8,9,17
42,28/11/2015,19,17,15,32
42,28/11/2015,20,7,9,16
42,28/11/2015,21,6,4,10
42,28/11/2015,22,8,4,12
42,28/11/2015,23,10,5,15
42,29/11/2015,0,5,2,7
42,29/11/2015,1,1,2,3
42,29/11/2015,2,3,2,5
42,29/11/2015,3,3,2,5
42,29/11/2015,4,2,3,5
42,29/11/2015,5,2,0,2
42,29/11/2015,6,0,1,1
42,29/11/2015,7,2,2,4
42,29/11/2015,8,2,4,6
42,29/11/2015,9,1,15,16
42,29/11/2015,10,5,13,18
42,29/11/2015,11,6,8,14
42,29/11/2015,12,11,11,22
42,29/11/2015,13,16,16,32
42,29/11/2015,14,19,11,30
42,29/11/2015,15,19,10,29
42,29/11/2015,16,9,10,19
42,29/11/2015,17,12,15,27
42,29/11/2015,18,11,10,21
42,29/11/2015,19,9,9,18
42,29/11/2015,20,12,11,23
42,29/11/2015,21,13,1,14
42,29/11/2015,22,8,6,14
42,29/11/2015,23,7,2,9
42,30/11/2015,0,4,3,7
42,30/11/2015,1,1,4,5
42,30/11/2015,2,0,1,1
42,30/11/2015,3,0,0,0
42,30/11/2015,4,1,0,1
42,30/11/2015,5,0,0,0
42,30/11/2015,6,3,8,11
42,30/11/2015,7,14,33,47
42,30/11/2015,8,33,100,133
42,30/11/2015,9,15,86,101
42,30/11/2015,10,12,31,43
42,30/11/2015,11,14,22,36
42,30/11/2015,12,18,20,38
42,30/11/2015,13,14,29,43
42,30/11/2015,14,17,27,44
42,30/11/2015,15,29,16,45
42,30/11/2015,16,43,38,81
42,30/11/2015,17,99,55,154
42,30/11/2015,18,62,30,92
42,30/11/2015,19,43,22,65
42,30/11/2015,20,34,13,47
42,30/11/2015,21,24,8,32
42,30/11/2015,22,17,3,20
42,30/11/2015,23,13,9,22
42,01/12/2015,0,4,0,4
42,01/12/2015,1,3,0,3
42,01/12/2015,2,2,0,2
42,01/12/2015,3,0,0,0
42,01/12/2015,4,0,0,0
42,01/12/2015,5,0,0,0
42,01/12/2015,6,3,4,7
42,01/12/2015,7,10,25,35
42,01/12/2015,8,28,85,113
42,01/12/2015,9,13,78,91
42,01/12/2015,10,5,25,30
42,01/12/2015,11,10,20,30
42,01/12/2015,12,13,9,22
42,01/12/2015,13,13,25,38
42,01/12/2015,14,19,10,29
42,01/12/2015,15,26,14,40
42,01/12/2015,16,41,23,64
42,01/12/2015,17,60,41,101
42,01/12/2015,18,56,34,90
42,01/12/2015,19,34,21,55
42,01/12/2015,20,24,9,33
42,01/12/2015,21,16,3,19
42,01/12/2015,22,15,5,20
42,01/12/2015,23,11,4,15
42,02/12/2015,0,6,3,9
42,02/12/2015,1,4,0,4
42,02/12/2015,2,6,0,6
42,02/12/2015,3,0,0,0
42,02/12/2015,4,0,0,0
42,02/12/2015,5,1,1,2
42,02/12/2015,6,5,5,10
42,02/12/2015,7,12,33,45
42,02/12/2015,8,39,74,113
42,02/12/2015,9,15,65,80
42,02/12/2015,10,8,32,40
42,02/12/2015,11,14,17,31
42,02/12/2015,12,19,16,35
42,02/12/2015,13,23,33,56
42,02/12/2015,14,29,20,49
42,02/12/2015,15,37,25,62
42,02/12/2015,16,44,38,82
42,02/12/2015,17,81,54,135
42,02/12/2015,18,39,43,82
42,02/12/2015,19,40,21,61
42,02/12/2015,20,27,10,37
42,02/12/2015,21,29,10,39
42,02/12/2015,22,24,10,34
42,02/12/2015,23,12,9,21
42,03/12/2015,0,4,8,12
42,03/12/2015,1,6,1,7
42,03/12/2015,2,1,1,2
42,03/12/2015,3,1,0,1
42,03/12/2015,4,0,0,0
42,03/12/2015,5,0,3,3
42,03/12/2015,6,2,7,9
42,03/12/2015,7,19,33,52
42,03/12/2015,8,35,100,135
42,03/12/2015,9,19,72,91
42,03/12/2015,10,10,44,54
42,03/12/2015,11,11,21,32
42,03/12/2015,12,15,37,52
42,03/12/2015,13,26,25,51
42,03/12/2015,14,17,14,31
42,03/12/2015,15,24,24,48
42,03/12/2015,16,48,24,72
42,03/12/2015,17,75,45,120
42,03/12/2015,18,45,25,70
42,03/12/2015,19,29,13,42
42,03/12/2015,20,19,12,31
42,03/12/2015,21,15,9,24
42,03/12/2015,22,13,7,20
42,03/12/2015,23,3,2,5
42,04/12/2015,0,7,2,9
42,04/12/2015,1,0,0,0
42,04/12/2015,2,2,1,3
42,04/12/2015,3,0,0,0
42,04/12/2015,4,0,1,1
42,04/12/2015,5,0,0,0
42,04/12/2015,6,3,9,12
42,04/12/2015,7,8,21,29
42,04/12/2015,8,24,59,83
42,04/12/2015,9,13,60,73
42,04/12/2015,10,15,33,48
42,04/12/2015,11,14,36,50
42,04/12/2015,12,24,13,37
42,04/12/2015,13,21,23,44
42,04/12/2015,14,13,16,29
42,04/12/2015,15,26,18,44
42,04/12/2015,16,38,18,56
42,04/12/2015,17,56,20,76
42,04/12/2015,18,41,15,56
42,04/12/2015,19,16,9,25
42,04/12/2015,20,12,8,20
42,04/12/2015,21,9,9,18
42,04/12/2015,22,7,3,10
42,04/12/2015,23,5,2,7
42,05/12/2015,0,4,6,10
42,05/12/2015,1,2,2,4
42,05/12/2015,2,2,1,3
42,05/12/2015,3,1,0,1
42,05/12/2015,4,0,2,2
42,05/12/2015,5,0,1,1
42,05/12/2015,6,1,0,1
42,05/12/2015,7,2,3,5
42,05/12/2015,8,1,3,4
42,05/12/2015,9,1,11,12
42,05/12/2015,10,7,10,17
42,05/12/2015,11,10,12,22
42,05/12/2015,12,5,13,18
42,05/12/2015,13,6,7,13
42,05/12/2015,14,6,12,18
42,05/12/2015,15,13,10,23
42,05/12/2015,16,10,9,19
42,05/12/2015,17,8,8,16
42,05/12/2015,18,14,6,20
42,05/12/2015,19,7,12,19
42,05/12/2015,20,9,5,14
42,05/12/2015,21,9,4,13
42,05/12/2015,22,5,5,10
42,05/12/2015,23,2,1,3
42,06/12/2015,0,4,4,8
42,06/12/2015,1,2,0,2
42,06/12/2015,2,3,0,3
42,06/12/2015,3,2,0,2
42,06/12/2015,4,0,0,0
42,06/12/2015,5,0,0,0
42,06/12/2015,6,1,1,2
42,06/12/2015,7,2,6,8
42,06/12/2015,8,4,6,10
42,06/12/2015,9,8,23,31
42,06/12/2015,10,14,21,35
42,06/12/2015,11,18,15,33
42,06/12/2015,12,17,20,37
42,06/12/2015,13,21,16,37
42,06/12/2015,14,23,26,49
42,06/12/2015,15,21,14,35
42,06/12/2015,16,15,11,26
42,06/12/2015,17,16,21,37
42,06/12/2015,18,24,7,31
42,06/12/2015,19,17,10,27
42,06/12/2015,20,12,8,20
42,06/12/2015,21,10,2,12
42,06/12/2015,22,8,5,13
42,06/12/2015,23,10,4,14
42,07/12/2015,0,4,4,8
42,07/12/2015,1,2,1,3
42,07/12/2015,2,4,0,4
42,07/12/2015,3,0,0,0
42,07/12/2015,4,1,0,1
42,07/12/2015,5,3,1,4
42,07/12/2015,6,7,8,15
42,07/12/2015,7,13,28,41
42,07/12/2015,8,36,87,123
42,07/12/2015,9,19,80,99
42,07/12/2015,10,13,31,44
42,07/12/2015,11,4,21,25
42,07/12/2015,12,15,17,32
42,07/12/2015,13,18,30,48
42,07/12/2015,14,18,16,34
42,07/12/2015,15,27,18,45
42,07/12/2015,16,35,30,65
42,07/12/2015,17,90,47,137
42,07/12/2015,18,52,25,77
42,07/12/2015,19,34,26,60
42,07/12/2015,20,24,13,37
42,07/12/2015,21,34,8,42
42,07/12/2015,22,13,4,17
42,07/12/2015,23,15,2,17
42,08/12/2015,0,10,2,12
42,08/12/2015,1,3,0,3
42,08/12/2015,2,3,0,3
42,08/12/2015,3,1,0,1
42,08/12/2015,4,0,0,0
42,08/12/2015,5,4,1,5
42,08/12/2015,6,4,7,11
42,08/12/2015,7,17,40,57
42,08/12/2015,8,33,87,120
42,08/12/2015,9,24,78,102
42,08/12/2015,10,15,46,61
42,08/12/2015,11,12,24,36
42,08/12/2015,12,18,26,44
42,08/12/2015,13,14,27,41
42,08/12/2015,14,20,24,44
42,08/12/2015,15,35,14,49
42,08/12/2015,16,41,25,66
42,08/12/2015,17,63,54,117
42,08/12/2015,18,57,32,89
42,08/12/2015,19,38,23,61
42,08/12/2015,20,38,11,49
42,08/12/2015,21,25,9,34
42,08/12/2015,22,17,4,21
42,08/12/2015,23,8,4,12
42,09/12/2015,0,5,0,5
42,09/12/2015,1,1,0,1
42,09/12/2015,2,0,0,0
42,09/12/2015,3,3,0,3
42,09/12/2015,4,0,0,0
42,09/12/2015,5,4,0,4
42,09/12/2015,6,5,10,15
42,09/12/2015,7,15,27,42
42,09/12/2015,8,22,83,105
42,09/12/2015,9,13,57,70
42,09/12/2015,10,11,38,49
42,09/12/2015,11,8,18,26
42,09/12/2015,12,18,16,34
42,09/12/2015,13,22,31,53
42,09/12/2015,14,14,15,29
42,09/12/2015,15,18,20,38
42,09/12/2015,16,30,27,57
42,09/12/2015,17,60,35,95
42,09/12/2015,18,33,14,47
42,09/12/2015,19,28,13,41
42,09/12/2015,20,27,9,36
42,09/12/2015,21,15,6,21
42,09/12/2015,22,17,6,23
42,09/12/2015,23,12,3,15
42,10/12/2015,0,4,2,6
42,10/12/2015,1,3,0,3
42,10/12/2015,2,2,0,2
42,10/12/2015,3,0,0,0
42,10/12/2015,4,1,0,1
42,10/12/2015,5,0,1,1
42,10/12/2015,6,1,6,7
42,10/12/2015,7,13,35,48
42,10/12/2015,8,27,79,106
42,10/12/2015,9,13,67,80
42,10/12/2015,10,9,31,40
42,10/12/2015,11,20,29,49
42,10/12/2015,12,17,22,39
42,10/12/2015,13,12,31,43
42,10/12/2015,14,28,29,57
42,10/12/2015,15,22,20,42
42,10/12/2015,16,29,25,54
42,10/12/2015,17,51,42,93
42,10/12/2015,18,45,19,64
42,10/12/2015,19,26,20,46
42,10/12/2015,20,25,11,36
42,10/12/2015,21,23,7,30
42,10/12/2015,22,19,4,23
42,10/12/2015,23,9,5,14
42,11/12/2015,0,1,0,1
42,11/12/2015,1,5,1,6
42,11/12/2015,2,1,0,1
42,11/12/2015,3,0,0,0
42,11/12/2015,4,0,1,1
42,11/12/2015,5,5,1,6
42,11/12/2015,6,2,7,9
42,11/12/2015,7,11,28,39
42,11/12/2015,8,22,61,83
42,11/12/2015,9,17,58,75
42,11/12/2015,10,6,25,31
42,11/12/2015,11,11,19,30
42,11/12/2015,12,16,14,30
42,11/12/2015,13,22,21,43
42,11/12/2015,14,18,21,39
42,11/12/2015,15,18,17,35
42,11/12/2015,16,33,22,55
42,11/12/2015,17,47,36,83
42,11/12/2015,18,35,17,52
42,11/12/2015,19,23,17,40
42,11/12/2015,20,14,11,25
42,11/12/2015,21,16,10,26
42,11/12/2015,22,11,2,13
42,11/12/2015,23,9,5,14
42,12/12/2015,0,10,3,13
42,12/12/2015,1,4,3,7
42,12/12/2015,2,2,1,3
42,12/12/2015,3,2,2,4
42,12/12/2015,4,0,1,1
42,12/12/2015,5,1,0,1
42,12/12/2015,6,1,0,1
42,12/12/2015,7,3,8,11
42,12/12/2015,8,4,16,20
42,12/12/2015,9,3,32,35
42,12/12/2015,10,12,29,41
42,12/12/2015,11,12,22,34
42,12/12/2015,12,10,9,19
42,12/12/2015,13,29,14,43
42,12/12/2015,14,13,24,37
42,12/12/2015,15,30,22,52
42,12/12/2015,16,14,10,24
42,12/12/2015,17,16,12,28
42,12/12/2015,18,14,11,25
42,12/12/2015,19,10,6,16
42,12/12/2015,20,10,5,15
42,12/12/2015,21,8,7,15
42,12/12/2015,22,13,4,17
42,12/12/2015,23,7,1,8
42,13/12/2015,0,4,5,9
42,13/12/2015,1,2,4,6
42,13/12/2015,2,7,1,8
42,13/12/2015,3,0,1,1
42,13/12/2015,4,2,0,2
42,13/12/2015,5,2,0,2
42,13/12/2015,6,0,3,3
42,13/12/2015,7,3,3,6
42,13/12/2015,8,3,3,6
42,13/12/2015,9,2,18,20
42,13/12/2015,10,9,16,25
42,13/12/2015,11,19,21,40
42,13/12/2015,12,15,10,25
42,13/12/2015,13,15,26,41
42,13/12/2015,14,21,18,39
42,13/12/2015,15,18,12,30
42,13/12/2015,16,10,13,23
42,13/12/2015,17,9,13,22
42,13/12/2015,18,11,6,17
42,13/12/2015,19,15,10,25
42,13/12/2015,20,12,3,15
42,13/12/2015,21,3,8,11
42,13/12/2015,22,7,2,9
42,13/12/2015,23,5,3,8
42,14/12/2015,0,3,2,5
42,14/12/2015,1,2,1,3
42,14/12/2015,2,0,1,1
42,14/12/2015,3,0,0,0
42,14/12/2015,4,0,0,0
42,14/12/2015,5,5,2,7
42,14/12/2015,6,5,6,11
42,14/12/2015,7,11,28,39
42,14/12/2015,8,34,80,114
42,14/12/2015,9,23,69,92
42,14/12/2015,10,9,29,38
42,14/12/2015,11,9,21,30
42,14/12/2015,12,14,25,39
42,14/12/2015,13,13,12,25
42,14/12/2015,14,24,19,43
42,14/12/2015,15,23,18,41
42,14/12/2015,16,36,22,58
42,14/12/2015,17,66,44,110
42,14/12/2015,18,58,29,87
42,14/12/2015,19,28,26,54
42,14/12/2015,20,23,14,37
42,14/12/2015,21,18,9,27
42,14/12/2015,22,9,9,18
42,14/12/2015,23,11,2,13
42,15/12/2015,0,3,2,5
42,15/12/2015,1,3,3,6
42,15/12/2015,2,1,0,1
42,15/12/2015,3,0,0,0
42,15/12/2015,4,0,0,0
42,15/12/2015,5,5,3,8
42,15/12/2015,6,5,6,11
42,15/12/2015,7,23,26,49
42,15/12/2015,8,31,96,127
42,15/12/2015,9,22,79,101
42,15/12/2015,10,10,36,46
42,15/12/2015,11,14,15,29
42,15/12/2015,12,18,21,39
42,15/12/2015,13,12,26,38
42,15/12/2015,14,22,11,33
42,15/12/2015,15,21,18,39
42,15/12/2015,16,40,32,72
42,15/12/2015,17,79,48,127
42,15/12/2015,18,54,32,86
42,15/12/2015,19,20,16,36
42,15/12/2015,20,20,15,35
42,15/12/2015,21,12,7,19
42,15/12/2015,22,14,4,18
42,15/12/2015,23,8,4,12
42,16/12/2015,0,1,1,2
42,16/12/2015,1,3,1,4
42,16/12/2015,2,1,1,2
42,16/12/2015,3,1,0,1
42,16/12/2015,4,0,0,0
42,16/12/2015,5,7,2,9
42,16/12/2015,6,3,8,11
42,16/12/2015,7,25,42,67
42,16/12/2015,8,34,86,120
42,16/12/2015,9,14,72,86
42,16/12/2015,10,17,36,53
42,16/12/2015,11,13,18,31
42,16/12/2015,12,16,20,36
42,16/12/2015,13,22,24,46
42,16/12/2015,14,17,14,31
42,16/12/2015,15,24,21,45
42,16/12/2015,16,35,29,64
42,16/12/2015,17,74,53,127
42,16/12/2015,18,59,23,82
42,16/12/2015,19,25,26,51
42,16/12/2015,20,22,7,29
42,16/12/2015,21,18,11,29
42,16/12/2015,22,16,7,23
42,16/12/2015,23,10,4,14
42,17/12/2015,0,6,0,6
42,17/12/2015,1,1,0,1
42,17/12/2015,2,1,2,3
42,17/12/2015,3,1,0,1
42,17/12/2015,4,1,0,1
42,17/12/2015,5,2,1,3
42,17/12/2015,6,2,4,6
42,17/12/2015,7,10,31,41
42,17/12/2015,8,27,89,116
42,17/12/2015,9,21,59,80
42,17/12/2015,10,10,31,41
42,17/12/2015,11,15,30,45
42,17/12/2015,12,19,14,33
42,17/12/2015,13,16,25,41
42,17/12/2015,14,26,18,44
42,17/12/2015,15,16,22,38
42,17/12/2015,16,37,26,63
42,17/12/2015,17,63,43,106
42,17/12/2015,18,41,19,60
42,17/12/2015,19,26,13,39
42,17/12/2015,20,15,7,22
42,17/12/2015,21,21,11,32
42,17/12/2015,22,12,13,25
42,17/12/2015,23,9,9,18
42,18/12/2015,0,10,5,15
42,18/12/2015,1,0,0,0
42,18/12/2015,2,3,0,3
42,18/12/2015,3,1,0,1
42,18/12/2015,4,0,0,0
42,18/12/2015,5,0,0,0
42,18/12/2015,6,3,8,11
42,18/12/2015,7,10,29,39
42,18/12/2015,8,23,67,90
42,18/12/2015,9,12,48,60
42,18/12/2015,10,14,32,46
42,18/12/2015,11,13,27,40
42,18/12/2015,12,21,26,47
42,18/12/2015,13,29,21,50
42,18/12/2015,14,24,19,43
42,18/12/2015,15,29,25,54
42,18/12/2015,16,25,18,43
42,18/12/2015,17,43,19,62
42,18/12/2015,18,38,15,53
42,18/12/2015,19,19,13,32
42,18/12/2015,20,10,11,21
42,18/12/2015,21,10,4,14
42,18/12/2015,22,7,4,11
42,18/12/2015,23,5,10,15
42,19/12/2015,0,6,7,13
42,19/12/2015,1,1,2,3
42,19/12/2015,2,0,3,3
42,19/12/2015,3,1,0,1
42,19/12/2015,4,1,1,2
42,19/12/2015,5,3,1,4
42,19/12/2015,6,3,1,4
42,19/12/2015,7,3,6,9
42,19/12/2015,8,0,15,15
42,19/12/2015,9,7,16,23
42,19/12/2015,10,8,13,21
42,19/12/2015,11,10,10,20
42,19/12/2015,12,17,15,32
42,19/12/2015,13,16,30,46
42,19/12/2015,14,13,17,30
42,19/12/2015,15,16,21,37
42,19/12/2015,16,22,16,38
42,19/12/2015,17,14,10,24
42,19/12/2015,18,9,8,17
42,19/12/2015,19,16,3,19
42,19/12/2015,20,12,5,17
42,19/12/2015,21,8,5,13
42,19/12/2015,22,5,4,9
42,19/12/2015,23,4,6,10
42,20/12/2015,0,7,4,11
42,20/12/2015,1,0,1,1
42,20/12/2015,2,1,1,2
42,20/12/2015,3,3,0,3
42,20/12/2015,4,0,0,0
42,20/12/2015,5,2,0,2
42,20/12/2015,6,4,0,4
42,20/12/2015,7,1,3,4
42,20/12/2015,8,3,4,7
42,20/12/2015,9,3,18,21
42,20/12/2015,10,6,9,15
42,20/12/2015,11,14,14,28
42,20/12/2015,12,11,10,21
42,20/12/2015,13,18,15,33
42,20/12/2015,14,14,13,27
42,20/12/2015,15,10,9,19
42,20/12/2015,16,9,6,15
42,20/12/2015,17,6,9,15
42,20/12/2015,18,4,8,12
42,20/12/2015,19,10,9,19
42,20/12/2015,20,7,6,13
42,20/12/2015,21,13,4,17
42,20/12/2015,22,7,2,9
42,20/12/2015,23,3,6,9
42,21/12/2015,0,1,1,2
42,21/12/2015,1,4,0,4
42,21/12/2015,2,2,1,3
42,21/12/2015,3,0,2,2
42,21/12/2015,4,1,0,1
42,21/12/2015,5,1,1,2
42,21/12/2015,6,3,7,10
42,21/12/2015,7,13,27,40
42,21/12/2015,8,24,53,77
42,21/12/2015,9,18,50,68
42,21/12/2015,10,14,16,30
42,21/12/2015,11,15,13,28
42,21/12/2015,12,8,9,17
42,21/12/2015,13,14,20,34
42,21/12/2015,14,17,21,38
42,21/12/2015,15,26,12,38
42,21/12/2015,16,28,20,48
42,21/12/2015,17,40,32,72
42,21/12/2015,18,31,10,41
42,21/12/2015,19,15,11,26
42,21/12/2015,20,9,1,10
42,21/12/2015,21,4,3,7
42,21/12/2015,22,8,5,13
42,21/12/2015,23,5,2,7
42,22/12/2015,0,4,1,5
42,22/12/2015,1,0,0,0
42,22/12/2015,2,2,0,2
42,22/12/2015,3,1,0,1
42,22/12/2015,4,0,0,0
42,22/12/2015,5,2,0,2
42,22/12/2015,6,0,4,4
42,22/12/2015,7,11,14,25
42,22/12/2015,8,14,37,51
42,22/12/2015,9,11,31,42
42,22/12/2015,10,6,6,12
42,22/12/2015,11,6,10,16
42,22/12/2015,12,11,11,22
42,22/12/2015,13,6,11,17
42,22/12/2015,14,16,15,31
42,22/12/2015,15,22,9,31
42,22/12/2015,16,26,19,45
42,22/12/2015,17,32,13,45
42,22/12/2015,18,18,9,27
42,22/12/2015,19,12,5,17
42,22/12/2015,20,11,1,12
42,22/12/2015,21,3,2,5
42,22/12/2015,22,4,4,8
42,22/12/2015,23,1,7,8
42,23/12/2015,0,3,3,6
42,23/12/2015,1,2,2,4
42,23/12/2015,2,0,0,0
42,23/12/2015,3,0,0,0
42,23/12/2015,4,0,0,0
42,23/12/2015,5,1,1,2
42,23/12/2015,6,1,2,3
42,23/12/2015,7,9,10,19
42,23/12/2015,8,11,22,33
42,23/12/2015,9,11,16,27
42,23/12/2015,10,6,11,17
42,23/12/2015,11,2,11,13
42,23/12/2015,12,8,14,22
42,23/12/2015,13,12,9,21
42,23/12/2015,14,14,7,21
42,23/12/2015,15,9,16,25
42,23/12/2015,16,9,5,14
42,23/12/2015,17,21,17,38
42,23/12/2015,18,6,10,16
42,23/12/2015,19,5,5,10
42,23/12/2015,20,5,3,8
42,23/12/2015,21,6,2,8
42,23/12/2015,22,1,1,2
42,23/12/2015,23,4,4,8
42,24/12/2015,0,2,2,4
42,24/12/2015,1,1,1,2
42,24/12/2015,2,0,0,0
42,24/12/2015,3,1,1,2
42,24/12/2015,4,0,0,0
42,24/12/2015,5,0,0,0
42,24/12/2015,6,0,1,1
42,24/12/2015,7,1,9,10
42,24/12/2015,8,6,9,15
42,24/12/2015,9,9,6,15
42,24/12/2015,10,8,7,15
42,24/12/2015,11,6,6,12
42,24/12/2015,12,5,6,11
42,24/12/2015,13,14,15,29
42,24/12/2015,14,9,6,15
42,24/12/2015,15,11,7,18
42,24/12/2015,16,7,7,14
42,24/12/2015,17,7,4,11
42,24/12/2015,18,3,4,7
42,24/12/2015,19,4,2,6
42,24/12/2015,20,0,3,3
42,24/12/2015,21,3,0,3
42,24/12/2015,22,2,0,2
42,24/12/2015,23,1,0,1
42,25/12/2015,0,1,0,1
42,25/12/2015,1,1,2,3
42,25/12/2015,2,0,0,0
42,25/12/2015,3,0,0,0
42,25/12/2015,4,0,0,0
42,25/12/2015,5,1,0,1
42,25/12/2015,6,0,0,0
42,25/12/2015,7,2,0,2
42,25/12/2015,8,0,3,3
42,25/12/2015,9,2,1,3
42,25/12/2015,10,4,10,14
42,25/12/2015,11,8,11,19
42,25/12/2015,12,4,8,12
42,25/12/2015,13,3,4,7
42,25/12/2015,14,3,2,5
42,25/12/2015,15,3,5,8
42,25/12/2015,16,2,3,5
42,25/12/2015,17,5,3,8
42,25/12/2015,18,3,0,3
42,25/12/2015,19,1,2,3
42,25/12/2015,20,0,0,0
42,25/12/2015,21,4,1,5
42,25/12/2015,22,0,1,1
42,25/12/2015,23,2,2,4
42,26/12/2015,0,0,1,1
42,26/12/2015,1,0,1,1
42,26/12/2015,2,0,0,0
42,26/12/2015,3,1,0,1
42,26/12/2015,4,0,0,0
42,26/12/2015,5,1,0,1
42,26/12/2015,6,0,1,1
42,26/12/2015,7,1,0,1
42,26/12/2015,8,2,4,6
42,26/12/2015,9,0,0,0
42,26/12/2015,10,0,1,1
42,26/12/2015,11,1,4,5
42,26/12/2015,12,0,2,2
42,26/12/2015,13,2,1,3
42,26/12/2015,14,6,1,7
42,26/12/2015,15,3,2,5
42,26/12/2015,16,1,0,1
42,26/12/2015,17,0,0,0
42,26/12/2015,18,0,3,3
42,26/12/2015,19,0,0,0
42,26/12/2015,20,2,1,3
42,26/12/2015,21,1,6,7
42,26/12/2015,22,2,0,2
42,26/12/2015,23,0,0,0
42,27/12/2015,0,1,1,2
42,27/12/2015,1,1,1,2
42,27/12/2015,2,0,0,0
42,27/12/2015,3,0,0,0
42,27/12/2015,4,0,0,0
42,27/12/2015,5,0,0,0
42,27/12/2015,6,2,1,3
42,27/12/2015,7,3,2,5
42,27/12/2015,8,3,2,5
42,27/12/2015,9,2,10,12
42,27/12/2015,10,6,15,21
42,27/12/2015,11,12,11,23
42,27/12/2015,12,13,8,21
42,27/12/2015,13,11,12,23
42,27/12/2015,14,7,13,20
42,27/12/2015,15,12,12,24
42,27/12/2015,16,7,5,12
42,27/12/2015,17,10,2,12
42,27/12/2015,18,3,0,3
42,27/12/2015,19,0,9,9
42,27/12/2015,20,5,5,10
42,27/12/2015,21,1,0,1
42,27/12/2015,22,2,1,3
42,27/12/2015,23,2,1,3
42,28/12/2015,0,0,4,4
42,28/12/2015,1,0,1,1
42,28/12/2015,2,1,0,1
42,28/12/2015,3,0,0,0
42,28/12/2015,4,0,0,0
42,28/12/2015,5,1,0,1
42,28/12/2015,6,1,2,3
42,28/12/2015,7,1,3,4
42,28/12/2015,8,3,8,11
42,28/12/2015,9,1,6,7
42,28/12/2015,10,9,4,13
42,28/12/2015,11,9,9,18
42,28/12/2015,12,7,10,17
42,28/12/2015,13,13,15,28
42,28/12/2015,14,8,12,20
42,28/12/2015,15,14,12,26
42,28/12/2015,16,9,8,17
42,28/12/2015,17,10,7,17
42,28/12/2015,18,10,8,18
42,28/12/2015,19,4,7,11
42,28/12/2015,20,6,6,12
42,28/12/2015,21,3,6,9
42,28/12/2015,22,5,0,5
42,28/12/2015,23,2,1,3
42,29/12/2015,0,2,1,3
42,29/12/2015,1,0,1,1
42,29/12/2015,2,0,0,0
42,29/12/2015,3,2,0,2
42,29/12/2015,4,0,0,0
42,29/12/2015,5,6,1,7
42,29/12/2015,6,0,3,3
42,29/12/2015,7,5,10,15
42,29/12/2015,8,8,17,25
42,29/12/2015,9,7,11,18
42,29/12/2015,10,6,23,29
42,29/12/2015,11,20,16,36
42,29/12/2015,12,15,12,27
42,29/12/2015,13,13,5,18
42,29/12/2015,14,21,20,41
42,29/12/2015,15,16,7,23
42,29/12/2015,16,12,12,24
42,29/12/2015,17,14,14,28
42,29/12/2015,18,6,9,15
42,29/12/2015,19,6,7,13
42,29/12/2015,20,4,2,6
42,29/12/2015,21,4,6,10
42,29/12/2015,22,1,2,3
42,29/12/2015,23,0,10,10
42,30/12/2015,0,1,1,2
42,30/12/2015,1,0,3,3
42,30/12/2015,2,2,1,3
42,30/12/2015,3,0,0,0
42,30/12/2015,4,0,0,0
42,30/12/2015,5,7,0,7
42,30/12/2015,6,1,1,2
42,30/12/2015,7,4,3,7
42,30/12/2015,8,4,9,13
42,30/12/2015,9,3,4,7
42,30/12/2015,10,2,3,5
42,30/12/2015,11,9,2,11
42,30/12/2015,12,2,4,6
42,30/12/2015,13,5,5,10
42,30/12/2015,14,5,6,11
42,30/12/2015,15,8,9,17
42,30/12/2015,16,7,1,8
42,30/12/2015,17,8,13,21
42,30/12/2015,18,2,13,15
42,30/12/2015,19,7,6,13
42,30/12/2015,20,4,4,8
42,30/12/2015,21,10,0,10
42,30/12/2015,22,1,2,3
42,30/12/2015,23,2,5,7
42,31/12/2015,0,2,1,3
42,31/12/2015,1,0,1,1
42,31/12/2015,2,0,0,0
42,31/12/2015,3,1,1,2
42,31/12/2015,4,1,0,1
42,31/12/2015,5,8,1,9
42,31/12/2015,6,0,0,0
42,31/12/2015,7,8,7,15
42,31/12/2015,8,8,15,23
42,31/12/2015,9,1,7,8
42,31/12/2015,10,16,7,23
42,31/12/2015,11,12,6,18
42,31/12/2015,12,11,9,20
42,31/12/2015,13,12,16,28
42,31/12/2015,14,24,20,44
42,31/12/2015,15,20,21,41
42,31/12/2015,16,12,14,26
42,31/12/2015,17,11,8,19
42,31/12/2015,18,3,7,10
42,31/12/2015,19,3,8,11
42,31/12/2015,20,1,4,5
42,31/12/2015,21,3,0,3
42,31/12/2015,22,5,4,9
42,31/12/2015,23,1,6,7
42,01/01/2016,0,7,2,9
42,01/01/2016,1,2,0,2
42,01/01/2016,2,0,2,2
42,01/01/2016,3,3,1,4
42,01/01/2016,4,0,0,0
42,01/01/2016,5,1,3,4
42,01/01/2016,6,0,0,0
42,01/01/2016,7,3,1,4
42,01/01/2016,8,0,2,2
42,01/01/2016,9,1,4,5
42,01/01/2016,10,1,5,6
42,01/01/2016,11,10,7,17
42,01/01/2016,12,7,20,27
42,01/01/2016,13,16,10,26
42,01/01/2016,14,6,14,20
42,01/01/2016,15,7,6,13
42,01/01/2016,16,17,12,29
42,01/01/2016,17,8,2,10
42,01/01/2016,18,8,5,13
42,01/01/2016,19,4,3,7
42,01/01/2016,20,3,4,7
42,01/01/2016,21,2,0,2
42,01/01/2016,22,1,2,3
42,01/01/2016,23,1,1,2
42,02/01/2016,0,1,2,3
42,02/01/2016,1,0,0,0
42,02/01/2016,2,0,0,0
42,02/01/2016,3,0,0,0
42,02/01/2016,4,0,0,0
42,02/01/2016,5,0,3,3
42,02/01/2016,6,3,0,3
42,02/01/2016,7,1,4,5
42,02/01/2016,8,2,2,4
42,02/01/2016,9,1,7,8
42,02/01/2016,10,8,13,21
42,02/01/2016,11,3,16,19
42,02/01/2016,12,12,8,20
42,02/01/2016,13,12,7,19
42,02/01/2016,14,19,6,25
42,02/01/2016,15,22,5,27
42,02/01/2016,16,9,6,15
42,02/01/2016,17,8,4,12
42,02/01/2016,18,1,4,5
42,02/01/2016,19,3,2,5
42,02/01/2016,20,5,6,11
42,02/01/2016,21,2,7,9
42,02/01/2016,22,3,3,6
42,02/01/2016,23,7,7,14
42,03/01/2016,0,1,4,5
42,03/01/2016,1,2,2,4
42,03/01/2016,2,0,1,1
42,03/01/2016,3,0,0,0
42,03/01/2016,4,1,0,1
42,03/01/2016,5,0,0,0
42,03/01/2016,6,0,1,1
42,03/01/2016,7,2,3,5
42,03/01/2016,8,1,3,4
42,03/01/2016,9,2,10,12
42,03/01/2016,10,12,18,30
42,03/01/2016,11,5,13,18
42,03/01/2016,12,12,16,28
42,03/01/2016,13,19,10,29
42,03/01/2016,14,12,19,31
42,03/01/2016,15,12,11,23
42,03/01/2016,16,6,4,10
42,03/01/2016,17,15,5,20
42,03/01/2016,18,7,6,13
42,03/01/2016,19,7,5,12
42,03/01/2016,20,2,10,12
42,03/01/2016,21,2,4,6
42,03/01/2016,22,2,2,4
42,03/01/2016,23,1,1,2
42,04/01/2016,0,0,2,2
42,04/01/2016,1,0,2,2
42,04/01/2016,2,0,0,0
42,04/01/2016,3,0,0,0
42,04/01/2016,4,0,1,1
42,04/01/2016,5,0,0,0
42,04/01/2016,6,0,1,1
42,04/01/2016,7,3,14,17
42,04/01/2016,8,21,17,38
42,04/01/2016,9,11,22,33
42,04/01/2016,10,13,24,37
42,04/01/2016,11,16,18,34
42,04/01/2016,12,17,19,36
42,04/01/2016,13,10,23,33
42,04/01/2016,14,20,9,29
42,04/01/2016,15,16,16,32
42,04/01/2016,16,18,12,30
42,04/01/2016,17,19,17,36
42,04/01/2016,18,17,9,26
42,04/01/2016,19,10,10,20
42,04/01/2016,20,12,9,21
42,04/01/2016,21,5,1,6
42,04/01/2016,22,1,3,4
42,04/01/2016,23,0,3,3
42,05/01/2016,0,0,0,0
42,05/01/2016,1,0,1,1
42,05/01/2016,2,0,1,1
42,05/01/2016,3,0,0,0
42,05/01/2016,4,1,0,1
42,05/01/2016,5,1,0,1
42,05/01/2016,6,1,5,6
42,05/01/2016,7,9,25,34
42,05/01/2016,8,29,70,99
42,05/01/2016,9,16,44,60
42,05/01/2016,10,3,24,27
42,05/01/2016,11,6,11,17
42,05/01/2016,12,5,8,13
42,05/01/2016,13,19,8,27
42,05/01/2016,14,8,8,16
42,05/01/2016,15,9,9,18
42,05/01/2016,16,34,11,45
42,05/01/2016,17,68,35,103
42,05/01/2016,18,32,19,51
42,05/01/2016,19,9,14,23
42,05/01/2016,20,9,8,17
42,05/01/2016,21,7,2,9
42,05/01/2016,22,2,2,4
42,05/01/2016,23,2,2,4
42,06/01/2016,0,0,1,1
42,06/01/2016,1,0,1,1
42,06/01/2016,2,0,0,0
42,06/01/2016,3,0,0,0
42,06/01/2016,4,2,0,2
42,06/01/2016,5,7,0,7
42,06/01/2016,6,5,5,10
42,06/01/2016,7,12,32,44
42,06/01/2016,8,41,81,122
42,06/01/2016,9,13,50,63
42,06/01/2016,10,18,33,51
42,06/01/2016,11,11,17,28
42,06/01/2016,12,8,11,19
42,06/01/2016,13,18,14,32
42,06/01/2016,14,15,16,31
42,06/01/2016,15,18,12,30
42,06/01/2016,16,37,22,59
42,06/01/2016,17,69,38,107
42,06/01/2016,18,49,24,73
42,06/01/2016,19,20,9,29
42,06/01/2016,20,12,12,24
42,06/01/2016,21,10,5,15
42,06/01/2016,22,3,0,3
42,06/01/2016,23,2,7,9
42,07/01/2016,0,1,3,4
42,07/01/2016,1,1,1,2
42,07/01/2016,2,1,0,1
42,07/01/2016,3,0,0,0
42,07/01/2016,4,3,0,3
42,07/01/2016,5,6,0,6
42,07/01/2016,6,3,4,7
42,07/01/2016,7,14,31,45
42,07/01/2016,8,26,76,102
42,07/01/2016,9,19,53,72
42,07/01/2016,10,15,25,40
42,07/01/2016,11,8,13,21
42,07/01/2016,12,10,10,20
42,07/01/2016,13,7,13,20
42,07/01/2016,14,8,14,22
42,07/01/2016,15,18,5,23
42,07/01/2016,16,34,19,53
42,07/01/2016,17,53,37,90
42,07/01/2016,18,45,16,61
42,07/01/2016,19,22,11,33
42,07/01/2016,20,13,8,21
42,07/01/2016,21,10,5,15
42,07/01/2016,22,3,3,6
42,07/01/2016,23,3,5,8
42,08/01/2016,0,0,1,1
42,08/01/2016,1,1,0,1
42,08/01/2016,2,0,0,0
42,08/01/2016,3,0,0,0
42,08/01/2016,4,0,0,0
42,08/01/2016,5,1,0,1
42,08/01/2016,6,5,8,13
42,08/01/2016,7,8,26,34
42,08/01/2016,8,31,63,94
42,08/01/2016,9,13,63,76
42,08/01/2016,10,11,30,41
42,08/01/2016,11,15,16,31
42,08/01/2016,12,17,16,33
42,08/01/2016,13,12,16,28
42,08/01/2016,14,10,21,31
42,08/01/2016,15,28,19,47
42,08/01/2016,16,36,26,62
42,08/01/2016,17,53,30,83
42,08/01/2016,18,40,18,58
42,08/01/2016,19,16,10,26
42,08/01/2016,20,11,9,20
42,08/01/2016,21,5,6,11
42,08/01/2016,22,7,2,9
42,08/01/2016,23,3,4,7
42,09/01/2016,0,2,6,8
42,09/01/2016,1,0,2,2
42,09/01/2016,2,2,1,3
42,09/01/2016,3,0,1,1
42,09/01/2016,4,0,0,0
42,09/01/2016,5,1,0,1
42,09/01/2016,6,0,0,0
42,09/01/2016,7,0,0,0
42,09/01/2016,8,4,5,9
42,09/01/2016,9,6,8,14
42,09/01/2016,10,8,25,33
42,09/01/2016,11,15,11,26
42,09/01/2016,12,24,12,36
42,09/01/2016,13,6,14,20
42,09/01/2016,14,15,14,29
42,09/01/2016,15,12,13,25
42,09/01/2016,16,19,8,27
42,09/01/2016,17,16,11,27
42,09/01/2016,18,11,4,15
42,09/01/2016,19,11,10,21
42,09/01/2016,20,5,4,9
42,09/01/2016,21,4,6,10
42,09/01/2016,22,4,4,8
42,09/01/2016,23,5,2,7
42,10/01/2016,0,1,3,4
42,10/01/2016,1,1,3,4
42,10/01/2016,2,0,0,0
42,10/01/2016,3,0,2,2
42,10/01/2016,4,0,0,0
42,10/01/2016,5,6,0,6
42,10/01/2016,6,9,0,9
42,10/01/2016,7,1,2,3
42,10/01/2016,8,3,5,8
42,10/01/2016,9,5,8,13
42,10/01/2016,10,5,19,24
42,10/01/2016,11,3,10,13
42,10/01/2016,12,12,12,24
42,10/01/2016,13,16,15,31
42,10/01/2016,14,12,15,27
42,10/01/2016,15,11,11,22
42,10/01/2016,16,7,5,12
42,10/01/2016,17,11,2,13
42,10/01/2016,18,13,8,21
42,10/01/2016,19,9,4,13
42,10/01/2016,20,2,4,6
42,10/01/2016,21,5,3,8
42,10/01/2016,22,6,5,11
42,10/01/2016,23,1,4,5
42,11/01/2016,0,0,2,2
42,11/01/2016,1,0,0,0
42,11/01/2016,2,0,0,0
42,11/01/2016,3,0,0,0
42,11/01/2016,4,3,0,3
42,11/01/2016,5,7,0,7
42,11/01/2016,6,5,9,14
42,11/01/2016,7,12,33,45
42,11/01/2016,8,38,100,138
42,11/01/2016,9,22,78,100
42,11/01/2016,10,7,40,47
42,11/01/2016,11,14,17,31
42,11/01/2016,12,22,24,46
42,11/01/2016,13,19,32,51
42,11/01/2016,14,29,21,50
42,11/01/2016,15,32,25,57
42,11/01/2016,16,42,24,66
42,11/01/2016,17,99,36,135
42,11/01/2016,18,74,29,103
42,11/01/2016,19,23,18,41
42,11/01/2016,20,29,5,34
42,11/01/2016,21,19,7,26
42,11/01/2016,22,8,8,16
42,11/01/2016,23,1,4,5
42,12/01/2016,0,5,1,6
42,12/01/2016,1,0,1,1
42,12/01/2016,2,0,0,0
42,12/01/2016,3,0,0,0
42,12/01/2016,4,3,0,3
42,12/01/2016,5,6,0,6
42,12/01/2016,6,4,5,9
42,12/01/2016,7,17,43,60
42,12/01/2016,8,33,97,130
42,12/01/2016,9,15,65,80
42,12/01/2016,10,13,36,49
42,12/01/2016,11,11,19,30
42,12/01/2016,12,29,17,46
42,12/01/2016,13,17,19,36
42,12/01/2016,14,18,19,37
42,12/01/2016,15,38,21,59
42,12/01/2016,16,39,21,60
42,12/01/2016,17,81,32,113
42,12/01/2016,18,54,31,85
42,12/01/2016,19,25,15,40
42,12/01/2016,20,29,17,46
42,12/01/2016,21,17,8,25
42,12/01/2016,22,8,7,15
42,12/01/2016,23,8,5,13
42,13/01/2016,0,3,1,4
42,13/01/2016,1,3,2,5
42,13/01/2016,2,1,0,1
42,13/01/2016,3,1,0,1
42,13/01/2016,4,3,0,3
42,13/01/2016,5,6,0,6
42,13/01/2016,6,3,6,9
42,13/01/2016,7,20,37,57
42,13/01/2016,8,42,107,149
42,13/01/2016,9,18,92,110
42,13/01/2016,10,9,39,48
42,13/01/2016,11,19,29,48
42,13/01/2016,12,27,20,47
42,13/01/2016,13,34,36,70
42,13/01/2016,14,25,23,48
42,13/01/2016,15,28,21,49
42,13/01/2016,16,47,38,85
42,13/01/2016,17,92,62,154
42,13/01/2016,18,52,40,92
42,13/01/2016,19,33,10,43
42,13/01/2016,20,28,11,39
42,13/01/2016,21,13,13,26
42,13/01/2016,22,16,2,18
42,13/01/2016,23,6,2,8
42,14/01/2016,0,5,1,6
42,14/01/2016,1,0,0,0
42,14/01/2016,2,0,0,0
42,14/01/2016,3,0,0,0
42,14/01/2016,4,0,0,0
42,14/01/2016,5,1,0,1
42,14/01/2016,6,4,9,13
42,14/01/2016,7,16,25,41
42,14/01/2016,8,39,98,137
42,14/01/2016,9,21,81,102
42,14/01/2016,10,7,33,40
42,14/01/2016,11,12,23,35
42,14/01/2016,12,20,24,44
42,14/01/2016,13,24,27,51
42,14/01/2016,14,15,34,49
42,14/01/2016,15,33,19,52
42,14/01/2016,16,48,35,83
42,14/01/2016,17,94,28,122
42,14/01/2016,18,58,24,82
42,14/01/2016,19,37,20,57
42,14/01/2016,20,36,11,47
42,14/01/2016,21,13,15,28
42,14/01/2016,22,5,6,11
42,14/01/2016,23,3,3,6
42,15/01/2016,0,3,4,7
42,15/01/2016,1,2,1,3
42,15/01/2016,2,1,0,1
42,15/01/2016,3,0,0,0
42,15/01/2016,4,0,0,0
42,15/01/2016,5,1,0,1
42,15/01/2016,6,1,8,9
42,15/01/2016,7,13,32,45
42,15/01/2016,8,29,73,102
42,15/01/2016,9,13,58,71
42,15/01/2016,10,8,38,46
42,15/01/2016,11,19,33,52
42,15/01/2016,12,30,20,50
42,15/01/2016,13,36,23,59
42,15/01/2016,14,23,24,47
42,15/01/2016,15,27,29,56
42,15/01/2016,16,48,25,73
42,15/01/2016,17,58,35,93
42,15/01/2016,18,47,14,61
42,15/01/2016,19,28,17,45
42,15/01/2016,20,16,9,25
42,15/01/2016,21,11,5,16
42,15/01/2016,22,5,3,8
42,15/01/2016,23,7,5,12
42,16/01/2016,0,6,5,11
42,16/01/2016,1,5,5,10
42,16/01/2016,2,1,0,1
42,16/01/2016,3,0,1,1
42,16/01/2016,4,0,1,1
42,16/01/2016,5,0,0,0
42,16/01/2016,6,1,6,7
42,16/01/2016,7,2,1,3
42,16/01/2016,8,4,6,10
42,16/01/2016,9,7,11,18
42,16/01/2016,10,13,38,51
42,16/01/2016,11,10,33,43
42,16/01/2016,12,14,29,43
42,16/01/2016,13,20,12,32
42,16/01/2016,14,22,28,50
42,16/01/2016,15,20,19,39
42,16/01/2016,16,24,12,36
42,16/01/2016,17,23,14,37
42,16/01/2016,18,14,7,21
42,16/01/2016,19,6,4,10
42,16/01/2016,20,5,10,15
42,16/01/2016,21,6,4,10
42,16/01/2016,22,2,2,4
42,16/01/2016,23,4,5,9
42,17/01/2016,0,2,2,4
42,17/01/2016,1,4,1,5
42,17/01/2016,2,0,0,0
42,17/01/2016,3,1,2,3
42,17/01/2016,4,0,0,0
42,17/01/2016,5,1,1,2
42,17/01/2016,6,1,1,2
42,17/01/2016,7,1,1,2
42,17/01/2016,8,3,2,5
42,17/01/2016,9,2,10,12
42,17/01/2016,10,8,9,17
42,17/01/2016,11,13,12,25
42,17/01/2016,12,11,13,24
42,17/01/2016,13,13,20,33
42,17/01/2016,14,14,15,29
42,17/01/2016,15,12,21,33
42,17/01/2016,16,19,16,35
42,17/01/2016,17,20,16,36
42,17/01/2016,18,15,10,25
42,17/01/2016,19,14,5,19
42,17/01/2016,20,4,6,10
42,17/01/2016,21,8,4,12
42,17/01/2016,22,3,2,5
42,17/01/2016,23,4,2,6
42,18/01/2016,0,1,2,3
42,18/01/2016,1,1,0,1
42,18/01/2016,2,0,0,0
42,18/01/2016,3,0,0,0
42,18/01/2016,4,4,0,4
42,18/01/2016,5,6,0,6
42,18/01/2016,6,2,3,5
42,18/01/2016,7,8,32,40
42,18/01/2016,8,22,86,108
42,18/01/2016,9,14,66,80
42,18/01/2016,10,9,34,43
42,18/01/2016,11,14,13,27
42,18/01/2016,12,13,19,32
42,18/01/2016,13,12,24,36
42,18/01/2016,14,15,18,33
42,18/01/2016,15,29,16,45
42,18/01/2016,16,36,22,58
42,18/01/2016,17,80,37,117
42,18/01/2016,18,43,14,57
42,18/01/2016,19,30,18,48
42,18/01/2016,20,20,11,31
42,18/01/2016,21,13,8,21
42,18/01/2016,22,15,6,21
42,18/01/2016,23,3,7,10
42,19/01/2016,0,4,1,5
42,19/01/2016,1,0,0,0
42,19/01/2016,2,0,0,0
42,19/01/2016,3,0,0,0
42,19/01/2016,4,4,0,4
42,19/01/2016,5,11,1,12
42,19/01/2016,6,10,6,16
42,19/01/2016,7,14,36,50
42,19/01/2016,8,33,122,155
42,19/01/2016,9,22,78,100
42,19/01/2016,10,20,40,60
42,19/01/2016,11,17,35,52
42,19/01/2016,12,26,15,41
42,19/01/2016,13,23,29,52
42,19/01/2016,14,29,18,47
42,19/01/2016,15,34,26,60
42,19/01/2016,16,46,43,89
42,19/01/2016,17,89,40,129
42,19/01/2016,18,64,37,101
42,19/01/2016,19,41,21,62
42,19/01/2016,20,36,19,55
42,19/01/2016,21,29,5,34
42,19/01/2016,22,13,5,18
42,19/01/2016,23,5,5,10
42,20/01/2016,0,4,1,5
42,20/01/2016,1,1,1,2
42,20/01/2016,2,0,0,0
42,20/01/2016,3,0,0,0
42,20/01/2016,4,6,0,6
42,20/01/2016,5,7,1,8
42,20/01/2016,6,3,7,10
42,20/01/2016,7,18,42,60
42,20/01/2016,8,40,101,141
42,20/01/2016,9,12,77,89
42,20/01/2016,10,12,55,67
42,20/01/2016,11,18,27,45
42,20/01/2016,12,18,29,47
42,20/01/2016,13,29,26,55
42,20/01/2016,14,25,20,45
42,20/01/2016,15,38,25,63
42,20/01/2016,16,45,25,70
42,20/01/2016,17,96,58,154
42,20/01/2016,18,59,36,95
42,20/01/2016,19,49,36,85
42,20/01/2016,20,31,7,38
42,20/01/2016,21,26,11,37
42,20/01/2016,22,11,8,19
42,20/01/2016,23,11,7,18
42,21/01/2016,0,3,2,5
42,21/01/2016,1,0,1,1
42,21/01/2016,2,1,1,2
42,21/01/2016,3,1,0,1
42,21/01/2016,4,0,0,0
42,21/01/2016,5,1,0,1
42,21/01/2016,6,1,7,8
42,21/01/2016,7,12,37,49
42,21/01/2016,8,39,112,151
42,21/01/2016,9,23,67,90
42,21/01/2016,10,18,38,56
42,21/01/2016,11,19,38,57
42,21/01/2016,12,17,29,46
42,21/01/2016,13,23,33,56
42,21/01/2016,14,33,26,59
42,21/01/2016,15,23,19,42
42,21/01/2016,16,49,21,70
42,21/01/2016,17,89,47,136
42,21/01/2016,18,60,27,87
42,21/01/2016,19,40,18,58
42,21/01/2016,20,36,11,47
42,21/01/2016,21,15,9,24
42,21/01/2016,22,9,11,20
42,21/01/2016,23,8,4,12
42,22/01/2016,0,6,1,7
42,22/01/2016,1,1,1,2
42,22/01/2016,2,0,0,0
42,22/01/2016,3,1,0,1
42,22/01/2016,4,0,0,0
42,22/01/2016,5,1,1,2
42,22/01/2016,6,3,7,10
42,22/01/2016,7,9,29,38
42,22/01/2016,8,32,75,107
42,22/01/2016,9,15,52,67
42,22/01/2016,10,9,32,41
42,22/01/2016,11,9,15,24
42,22/01/2016,12,27,16,43
42,22/01/2016,13,23,24,47
42,22/01/2016,14,19,12,31
42,22/01/2016,15,27,26,53
42,22/01/2016,16,41,30,71
42,22/01/2016,17,80,35,115
42,22/01/2016,18,51,24,75
42,22/01/2016,19,32,21,53
42,22/01/2016,20,29,9,38
42,22/01/2016,21,13,8,21
42,22/01/2016,22,10,5,15
42,22/01/2016,23,6,5,11
42,23/01/2016,0,3,3,6
42,23/01/2016,1,5,1,6
42,23/01/2016,2,0,1,1
42,23/01/2016,3,1,0,1
42,23/01/2016,4,1,0,1
42,23/01/2016,5,0,0,0
42,23/01/2016,6,0,3,3
42,23/01/2016,7,0,3,3
42,23/01/2016,8,4,10,14
42,23/01/2016,9,12,16,28
42,23/01/2016,10,13,36,49
42,23/01/2016,11,34,33,67
42,23/01/2016,12,17,33,50
42,23/01/2016,13,25,19,44
42,23/01/2016,14,26,33,59
42,23/01/2016,15,38,34,72
42,23/01/2016,16,45,13,58
42,23/01/2016,17,22,14,36
42,23/01/2016,18,15,13,28
42,23/01/2016,19,10,13,23
42,23/01/2016,20,11,12,23
42,23/01/2016,21,6,2,8
42,23/01/2016,22,4,4,8
42,23/01/2016,23,6,4,10
42,24/01/2016,0,4,2,6
42,24/01/2016,1,0,4,4
42,24/01/2016,2,1,0,1
42,24/01/2016,3,0,0,0
42,24/01/2016,4,1,0,1
42,24/01/2016,5,1,0,1
42,24/01/2016,6,1,1,2
42,24/01/2016,7,3,5,8
42,24/01/2016,8,0,9,9
42,24/01/2016,9,8,10,18
42,24/01/2016,10,10,20,30
42,24/01/2016,11,15,16,31
42,24/01/2016,12,14,24,38
42,24/01/2016,13,18,19,37
42,24/01/2016,14,25,20,45
42,24/01/2016,15,31,24,55
42,24/01/2016,16,24,17,41
42,24/01/2016,17,24,12,36
42,24/01/2016,18,18,17,35
42,24/01/2016,19,15,13,28
42,24/01/2016,20,11,7,18
42,24/01/2016,21,7,4,11
42,24/01/2016,22,8,2,10
42,24/01/2016,23,4,2,6
42,25/01/2016,0,4,3,7
42,25/01/2016,1,1,1,2
42,25/01/2016,2,0,0,0
42,25/01/2016,3,0,0,0
42,25/01/2016,4,0,0,0
42,25/01/2016,5,1,0,1
42,25/01/2016,6,8,8,16
42,25/01/2016,7,12,40,52
42,25/01/2016,8,41,95,136
42,25/01/2016,9,19,85,104
42,25/01/2016,10,13,37,50
42,25/01/2016,11,15,25,40
42,25/01/2016,12,16,20,36
42,25/01/2016,13,27,19,46
42,25/01/2016,14,20,31,51
42,25/01/2016,15,29,16,45
42,25/01/2016,16,43,27,70
42,25/01/2016,17,94,52,146
42,25/01/2016,18,55,33,88
42,25/01/2016,19,39,23,62
42,25/01/2016,20,25,12,37
42,25/01/2016,21,19,5,24
42,25/01/2016,22,11,8,19
42,25/01/2016,23,7,7,14
42,26/01/2016,0,6,3,9
42,26/01/2016,1,1,0,1
42,26/01/2016,2,0,0,0
42,26/01/2016,3,0,0,0
42,26/01/2016,4,0,0,0
42,26/01/2016,5,0,0,0
42,26/01/2016,6,2,6,8
42,26/01/2016,7,14,21,35
42,26/01/2016,8,15,82,97
42,26/01/2016,9,10,39,49
42,26/01/2016,10,6,22,28
42,26/01/2016,11,3,14,17
42,26/01/2016,12,8,15,23
42,26/01/2016,13,8,12,20
42,26/01/2016,14,13,15,28
42,26/01/2016,15,15,12,27
42,26/01/2016,16,37,20,57
42,26/01/2016,17,56,28,84
42,26/01/2016,18,47,21,68
42,26/01/2016,19,37,20,57
42,26/01/2016,20,30,15,45
42,26/01/2016,21,18,9,27
42,26/01/2016,22,11,3,14
42,26/01/2016,23,7,3,10
42,27/01/2016,0,7,2,9
42,27/01/2016,1,2,0,2
42,27/01/2016,2,0,1,1
42,27/01/2016,3,0,0,0
42,27/01/2016,4,2,1,3
42,27/01/2016,5,0,1,1
42,27/01/2016,6,3,4,7
42,27/01/2016,7,16,28,44
42,27/01/2016,8,22,94,116
42,27/01/2016,9,11,65,76
42,27/01/2016,10,6,19,25
42,27/01/2016,11,10,26,36
42,27/01/2016,12,11,17,28
42,27/01/2016,13,13,19,32
42,27/01/2016,14,16,24,40
42,27/01/2016,15,14,14,28
42,27/01/2016,16,34,24,58
42,27/01/2016,17,77,41,118
42,27/01/2016,18,61,27,88
42,27/01/2016,19,36,20,56
42,27/01/2016,20,24,6,30
42,27/01/2016,21,20,7,27
42,27/01/2016,22,12,9,21
42,27/01/2016,23,13,7,20
42,28/01/2016,0,1,2,3
42,28/01/2016,1,1,1,2
42,28/01/2016,2,1,0,1
42,28/01/2016,3,0,0,0
42,28/01/2016,4,0,0,0
42,28/01/2016,5,2,0,2
42,28/01/2016,6,2,4,6
42,28/01/2016,7,20,32,52
42,28/01/2016,8,27,113,140
42,28/01/2016,9,19,61,80
42,28/01/2016,10,14,36,50
42,28/01/2016,11,13,22,35
42,28/01/2016,12,22,30,52
42,28/01/2016,13,20,22,42
42,28/01/2016,14,24,21,45
42,28/01/2016,15,22,18,40
42,28/01/2016,16,37,17,54
42,28/01/2016,17,86,36,122
42,28/01/2016,18,48,26,74
42,28/01/2016,19,26,15,41
42,28/01/2016,20,16,8,24
42,28/01/2016,21,17,10,27
42,28/01/2016,22,15,6,21
42,28/01/2016,23,8,5,13
42,29/01/2016,0,4,0,4
42,29/01/2016,1,0,1,1
42,29/01/2016,2,0,0,0
42,29/01/2016,3,0,0,0
42,29/01/2016,4,0,0,0
42,29/01/2016,5,0,0,0
42,29/01/2016,6,2,5,7
42,29/01/2016,7,3,13,16
42,29/01/2016,8,13,37,50
42,29/01/2016,9,8,53,61
42,29/01/2016,10,11,28,39
42,29/01/2016,11,12,10,22
42,29/01/2016,12,20,19,39
42,29/01/2016,13,20,22,42
42,29/01/2016,14,10,22,32
42,29/01/2016,15,20,19,39
42,29/01/2016,16,23,13,36
42,29/01/2016,17,41,19,60
42,29/01/2016,18,35,8,43
42,29/01/2016,19,20,16,36
42,29/01/2016,20,9,13,22
42,29/01/2016,21,16,8,24
42,29/01/2016,22,7,1,8
42,29/01/2016,23,4,8,12
42,30/01/2016,0,4,2,6
42,30/01/2016,1,2,2,4
42,30/01/2016,2,3,0,3
42,30/01/2016,3,1,0,1
42,30/01/2016,4,0,0,0
42,30/01/2016,5,2,0,2
42,30/01/2016,6,1,2,3
42,30/01/2016,7,0,2,2
42,30/01/2016,8,1,3,4
42,30/01/2016,9,2,8,10
42,30/01/2016,10,7,9,16
42,30/01/2016,11,9,13,22
42,30/01/2016,12,8,11,19
42,30/01/2016,13,11,10,21
42,30/01/2016,14,10,16,26
42,30/01/2016,15,16,11,27
42,30/01/2016,16,10,18,28
42,30/01/2016,17,15,6,21
42,30/01/2016,18,18,7,25
42,30/01/2016,19,7,11,18
42,30/01/2016,20,6,5,11
42,30/01/2016,21,5,6,11
42,30/01/2016,22,14,7,21
42,30/01/2016,23,3,3,6
42,31/01/2016,0,1,4,5
42,31/01/2016,1,3,4,7
42,31/01/2016,2,1,1,2
42,31/01/2016,3,3,2,5
42,31/01/2016,4,1,1,2
42,31/01/2016,5,0,0,0
42,31/01/2016,6,0,3,3
42,31/01/2016,7,1,1,2
42,31/01/2016,8,2,7,9
42,31/01/2016,9,5,14,19
42,31/01/2016,10,17,17,34
42,31/01/2016,11,9,16,25
42,31/01/2016,12,15,17,32
42,31/01/2016,13,14,27,41
42,31/01/2016,14,18,29,47
42,31/01/2016,15,25,22,47
42,31/01/2016,16,26,10,36
42,31/01/2016,17,17,11,28
42,31/01/2016,18,26,10,36
42,31/01/2016,19,14,3,17
42,31/01/2016,20,3,11,14
42,31/01/2016,21,3,5,8
42,31/01/2016,22,7,2,9
42,31/01/2016,23,6,3,9
42,01/02/2016,0,0,2,2
42,01/02/2016,1,0,0,0
42,01/02/2016,2,0,0,0
42,01/02/2016,3,0,0,0
42,01/02/2016,4,0,0,0
42,01/02/2016,5,0,0,0
42,01/02/2016,6,3,2,5
42,01/02/2016,7,8,21,29
42,01/02/2016,8,20,65,85
42,01/02/2016,9,10,59,69
42,01/02/2016,10,5,25,30
42,01/02/2016,11,13,18,31
42,01/02/2016,12,10,21,31
42,01/02/2016,13,21,20,41
42,01/02/2016,14,13,20,33
42,01/02/2016,15,19,15,34
42,01/02/2016,16,28,16,44
42,01/02/2016,17,63,28,91
42,01/02/2016,18,40,18,58
42,01/02/2016,19,36,17,53
42,01/02/2016,20,22,9,31
42,01/02/2016,21,16,9,25
42,01/02/2016,22,7,3,10
42,01/02/2016,23,4,3,7
42,02/02/2016,0,2,1,3
42,02/02/2016,1,1,0,1
42,02/02/2016,2,0,0,0
42,02/02/2016,3,1,0,1
42,02/02/2016,4,0,0,0
42,02/02/2016,5,1,0,1
42,02/02/2016,6,0,1,1
42,02/02/2016,7,9,28,37
42,02/02/2016,8,15,83,98
42,02/02/2016,9,19,56,75
42,02/02/2016,10,6,24,30
42,02/02/2016,11,13,17,30
42,02/02/2016,12,14,13,27
42,02/02/2016,13,11,23,34
42,02/02/2016,14,19,13,32
42,02/02/2016,15,28,16,44
42,02/02/2016,16,31,24,55
42,02/02/2016,17,76,35,111
42,02/02/2016,18,46,32,78
42,02/02/2016,19,28,13,41
42,02/02/2016,20,26,12,38
42,02/02/2016,21,26,10,36
42,02/02/2016,22,10,6,16
42,02/02/2016,23,9,3,12
42,03/02/2016,0,5,1,6
42,03/02/2016,1,2,1,3
42,03/02/2016,2,1,0,1
42,03/02/2016,3,1,1,2
42,03/02/2016,4,0,0,0
42,03/02/2016,5,0,1,1
42,03/02/2016,6,6,4,10
42,03/02/2016,7,11,33,44
42,03/02/2016,8,35,108,143
42,03/02/2016,9,24,78,102
42,03/02/2016,10,11,32,43
42,03/02/2016,11,19,26,45
42,03/02/2016,12,19,25,44
42,03/02/2016,13,34,35,69
42,03/02/2016,14,31,26,57
42,03/02/2016,15,32,24,56
42,03/02/2016,16,53,28,81
42,03/02/2016,17,82,61,143
42,03/02/2016,18,56,34,90
42,03/02/2016,19,35,23,58
42,03/02/2016,20,20,5,25
42,03/02/2016,21,27,9,36
42,03/02/2016,22,11,5,16
42,03/02/2016,23,9,4,13
42,04/02/2016,0,1,3,4
42,04/02/2016,1,1,1,2
42,04/02/2016,2,0,0,0
42,04/02/2016,3,0,0,0
42,04/02/2016,4,0,0,0
42,04/02/2016,5,1,0,1
42,04/02/2016,6,2,2,4
42,04/02/2016,7,13,41,54
42,04/02/2016,8,40,122,162
42,04/02/2016,9,22,68,90
42,04/02/2016,10,17,31,48
42,04/02/2016,11,18,24,42
42,04/02/2016,12,24,25,49
42,04/02/2016,13,21,27,48
42,04/02/2016,14,34,18,52
42,04/02/2016,15,31,20,51
42,04/02/2016,16,49,35,84
42,04/02/2016,17,80,52,132
42,04/02/2016,18,68,25,93
42,04/02/2016,19,48,21,69
42,04/02/2016,20,35,16,51
42,04/02/2016,21,15,17,32
42,04/02/2016,22,9,4,13
42,04/02/2016,23,8,5,13
42,05/02/2016,0,7,2,9
42,05/02/2016,1,0,2,2
42,05/02/2016,2,0,1,1
42,05/02/2016,3,0,0,0
42,05/02/2016,4,0,0,0
42,05/02/2016,5,1,0,1
42,05/02/2016,6,2,4,6
42,05/02/2016,7,11,35,46
42,05/02/2016,8,33,80,113
42,05/02/2016,9,6,74,80
42,05/02/2016,10,21,29,50
42,05/02/2016,11,19,15,34
42,05/02/2016,12,32,33,65
42,05/02/2016,13,23,21,44
42,05/02/2016,14,27,14,41
42,05/02/2016,15,18,23,41
42,05/02/2016,16,49,28,77
42,05/02/2016,17,66,31,97
42,05/02/2016,18,36,21,57
42,05/02/2016,19,29,18,47
42,05/02/2016,20,17,8,25
42,05/02/2016,21,9,6,15
42,05/02/2016,22,14,5,19
42,05/02/2016,23,6,3,9
42,06/02/2016,0,3,2,5
42,06/02/2016,1,5,2,7
42,06/02/2016,2,3,1,4
42,06/02/2016,3,2,0,2
42,06/02/2016,4,0,0,0
42,06/02/2016,5,0,0,0
42,06/02/2016,6,0,0,0
42,06/02/2016,7,1,2,3
42,06/02/2016,8,5,13,18
42,06/02/2016,9,14,26,40
42,06/02/2016,10,17,39,56
42,06/02/2016,11,16,26,42
42,06/02/2016,12,19,23,42
42,06/02/2016,13,22,20,42
42,06/02/2016,14,16,33,49
42,06/02/2016,15,11,23,34
42,06/02/2016,16,26,23,49
42,06/02/2016,17,31,12,43
42,06/02/2016,18,12,17,29
42,06/02/2016,19,18,11,29
42,06/02/2016,20,11,10,21
42,06/02/2016,21,7,5,12
42,06/02/2016,22,8,5,13
42,06/02/2016,23,9,4,13
42,07/02/2016,0,3,7,10
42,07/02/2016,1,3,1,4
42,07/02/2016,2,3,1,4
42,07/02/2016,3,2,3,5
42,07/02/2016,4,0,0,0
42,07/02/2016,5,0,0,0
42,07/02/2016,6,1,1,2
42,07/02/2016,7,2,2,4
42,07/02/2016,8,3,5,8
42,07/02/2016,9,1,15,16
42,07/02/2016,10,2,10,12
42,07/02/2016,11,9,12,21
42,07/02/2016,12,13,11,24
42,07/02/2016,13,8,8,16
42,07/02/2016,14,15,10,25
42,07/02/2016,15,11,8,19
42,07/02/2016,16,16,11,27
42,07/02/2016,17,16,7,23
42,07/02/2016,18,22,12,34
42,07/02/2016,19,11,5,16
42,07/02/2016,20,9,6,15
42,07/02/2016,21,6,6,12
42,07/02/2016,22,13,7,20
42,07/02/2016,23,7,1,8
42,08/02/2016,0,3,2,5
42,08/02/2016,1,1,2,3
42,08/02/2016,2,1,0,1
42,08/02/2016,3,1,0,1
42,08/02/2016,4,0,0,0
42,08/02/2016,5,1,0,1
42,08/02/2016,6,6,5,11
42,08/02/2016,7,10,40,50
42,08/02/2016,8,31,96,127
42,08/02/2016,9,24,66,90
42,08/02/2016,10,11,31,42
42,08/02/2016,11,8,21,29
42,08/02/2016,12,12,20,32
42,08/02/2016,13,16,18,34
42,08/02/2016,14,20,25,45
42,08/02/2016,15,19,18,37
42,08/02/2016,16,51,29,80
42,08/02/2016,17,79,41,120
42,08/02/2016,18,54,34,88
42,08/02/2016,19,53,21,74
42,08/02/2016,20,35,20,55
42,08/02/2016,21,15,12,27
42,08/02/2016,22,19,2,21
42,08/02/2016,23,6,7,13
42,09/02/2016,0,3,3,6
42,09/02/2016,1,3,0,3
42,09/02/2016,2,2,0,2
42,09/02/2016,3,0,0,0
42,09/02/2016,4,0,0,0
42,09/02/2016,5,0,1,1
42,09/02/2016,6,5,6,11
42,09/02/2016,7,15,36,51
42,09/02/2016,8,35,107,142
42,09/02/2016,9,18,67,85
42,09/02/2016,10,12,45,57
42,09/02/2016,11,9,25,34
42,09/02/2016,12,20,23,43
42,09/02/2016,13,23,27,50
42,09/02/2016,14,29,31,60
42,09/02/2016,15,27,17,44
42,09/02/2016,16,53,33,86
42,09/02/2016,17,89,51,140
42,09/02/2016,18,64,27,91
42,09/02/2016,19,34,23,57
42,09/02/2016,20,32,14,46
42,09/02/2016,21,18,6,24
42,09/02/2016,22,13,2,15
42,09/02/2016,23,9,4,13
42,10/02/2016,0,1,2,3
42,10/02/2016,1,4,0,4
42,10/02/2016,2,2,0,2
42,10/02/2016,3,0,0,0
42,10/02/2016,4,0,0,0
42,10/02/2016,5,0,1,1
42,10/02/2016,6,3,6,9
42,10/02/2016,7,16,46,62
42,10/02/2016,8,32,102,134
42,10/02/2016,9,27,82,109
42,10/02/2016,10,11,51,62
42,10/02/2016,11,23,39,62
42,10/02/2016,12,31,29,60
42,10/02/2016,13,37,28,65
42,10/02/2016,14,35,28,63
42,10/02/2016,15,45,24,69
42,10/02/2016,16,52,35,87
42,10/02/2016,17,91,62,153
42,10/02/2016,18,65,30,95
42,10/02/2016,19,40,22,62
42,10/02/2016,20,32,15,47
42,10/02/2016,21,23,7,30
42,10/02/2016,22,11,4,15
42,10/02/2016,23,9,9,18
42,11/02/2016,0,4,6,10
42,11/02/2016,1,3,0,3
42,11/02/2016,2,0,0,0
42,11/02/2016,3,0,0,0
42,11/02/2016,4,0,0,0
42,11/02/2016,5,1,0,1
42,11/02/2016,6,3,0,3
42,11/02/2016,7,16,32,48
42,11/02/2016,8,31,110,141
42,11/02/2016,9,21,75,96
42,11/02/2016,10,13,31,44
42,11/02/2016,11,17,33,50
42,11/02/2016,12,18,22,40
42,11/02/2016,13,19,17,36
42,11/02/2016,14,18,21,39
42,11/02/2016,15,30,18,48
42,11/02/2016,16,45,29,74
42,11/02/2016,17,71,55,126
42,11/02/2016,18,48,37,85
42,11/02/2016,19,39,20,59
42,11/02/2016,20,32,13,45
42,11/02/2016,21,23,9,32
42,11/02/2016,22,13,5,18
42,11/02/2016,23,11,4,15
42,12/02/2016,0,1,3,4
42,12/02/2016,1,6,1,7
42,12/02/2016,2,0,1,1
42,12/02/2016,3,0,1,1
42,12/02/2016,4,0,0,0
42,12/02/2016,5,1,0,1
42,12/02/2016,6,1,6,7
42,12/02/2016,7,14,23,37
42,12/02/2016,8,27,65,92
42,12/02/2016,9,14,61,75
42,12/02/2016,10,12,46,58
42,12/02/2016,11,19,23,42
42,12/02/2016,12,31,28,59
42,12/02/2016,13,31,22,53
42,12/02/2016,14,27,28,55
42,12/02/2016,15,27,17,44
42,12/02/2016,16,45,26,71
42,12/02/2016,17,59,36,95
42,12/02/2016,18,43,34,77
42,12/02/2016,19,22,18,40
42,12/02/2016,20,16,5,21
42,12/02/2016,21,18,7,25
42,12/02/2016,22,8,5,13
42,12/02/2016,23,8,6,14
42,13/02/2016,0,4,2,6
42,13/02/2016,1,5,1,6
42,13/02/2016,2,0,0,0
42,13/02/2016,3,1,1,2
42,13/02/2016,4,0,0,0
42,13/02/2016,5,1,0,1
42,13/02/2016,6,0,1,1
42,13/02/2016,7,1,1,2
42,13/02/2016,8,3,9,12
42,13/02/2016,9,3,11,14
42,13/02/2016,10,8,22,30
42,13/02/2016,11,7,15,22
42,13/02/2016,12,12,10,22
42,13/02/2016,13,10,6,16
42,13/02/2016,14,13,11,24
42,13/02/2016,15,8,9,17
42,13/02/2016,16,6,14,20
42,13/02/2016,17,15,12,27
42,13/02/2016,18,8,10,18
42,13/02/2016,19,18,10,28
42,13/02/2016,20,9,7,16
42,13/02/2016,21,5,4,9
42,13/02/2016,22,8,6,14
42,13/02/2016,23,7,6,13
42,14/02/2016,0,6,2,8
42,14/02/2016,1,3,2,5
42,14/02/2016,2,1,1,2
42,14/02/2016,3,0,2,2
42,14/02/2016,4,4,0,4
42,14/02/2016,5,0,0,0
42,14/02/2016,6,0,1,1
42,14/02/2016,7,4,2,6
42,14/02/2016,8,3,9,12
42,14/02/2016,9,3,15,18
42,14/02/2016,10,15,24,39
42,14/02/2016,11,17,16,33
42,14/02/2016,12,19,14,33
42,14/02/2016,13,15,35,50
42,14/02/2016,14,26,19,45
42,14/02/2016,15,19,21,40
42,14/02/2016,16,25,26,51
42,14/02/2016,17,15,12,27
42,14/02/2016,18,18,9,27
42,14/02/2016,19,16,10,26
42,14/02/2016,20,7,7,14
42,14/02/2016,21,5,1,6
42,14/02/2016,22,6,4,10
42,14/02/2016,23,4,1,5
42,15/02/2016,0,1,8,9
42,15/02/2016,1,0,0,0
42,15/02/2016,2,0,1,1
42,15/02/2016,3,0,0,0
42,15/02/2016,4,0,0,0
42,15/02/2016,5,1,0,1
42,15/02/2016,6,3,3,6
42,15/02/2016,7,13,31,44
42,15/02/2016,8,24,75,99
42,15/02/2016,9,15,62,77
42,15/02/2016,10,12,27,39
42,15/02/2016,11,15,27,42
42,15/02/2016,12,14,18,32
42,15/02/2016,13,21,24,45
42,15/02/2016,14,23,23,46
42,15/02/2016,15,18,26,44
42,15/02/2016,16,52,31,83
42,15/02/2016,17,68,48,116
42,15/02/2016,18,56,21,77
42,15/02/2016,19,34,17,51
42,15/02/2016,20,27,11,38
42,15/02/2016,21,21,6,27
42,15/02/2016,22,17,6,23
42,15/02/2016,23,7,2,9
42,16/02/2016,0,0,0,0
42,16/02/2016,1,0,0,0
42,16/02/2016,2,0,0,0
42,16/02/2016,3,0,1,1
42,16/02/2016,4,0,0,0
42,16/02/2016,5,0,2,2
42,16/02/2016,6,2,4,6
42,16/02/2016,7,12,25,37
42,16/02/2016,8,27,86,113
42,16/02/2016,9,16,51,67
42,16/02/2016,10,12,26,38
42,16/02/2016,11,8,18,26
42,16/02/2016,12,17,23,40
42,16/02/2016,13,11,27,38
42,16/02/2016,14,14,13,27
42,16/02/2016,15,18,11,29
42,16/02/2016,16,25,16,41
42,16/02/2016,17,75,39,114
42,16/02/2016,18,53,16,69
42,16/02/2016,19,27,10,37
42,16/02/2016,20,21,8,29
42,16/02/2016,21,12,4,16
42,16/02/2016,22,9,4,13
42,16/02/2016,23,3,2,5
42,17/02/2016,0,0,1,1
42,17/02/2016,1,3,1,4
42,17/02/2016,2,0,0,0
42,17/02/2016,3,0,0,0
42,17/02/2016,4,0,0,0
42,17/02/2016,5,1,0,1
42,17/02/2016,6,1,3,4
42,17/02/2016,7,10,15,25
42,17/02/2016,8,19,63,82
42,17/02/2016,9,22,56,78
42,17/02/2016,10,8,30,38
42,17/02/2016,11,14,19,33
42,17/02/2016,12,17,17,34
42,17/02/2016,13,13,21,34
42,17/02/2016,14,12,15,27
42,17/02/2016,15,21,22,43
42,17/02/2016,16,37,31,68
42,17/02/2016,17,66,51,117
42,17/02/2016,18,45,20,65
42,17/02/2016,19,38,17,55
42,17/02/2016,20,22,8,30
42,17/02/2016,21,24,8,32
42,17/02/2016,22,9,9,18
42,17/02/2016,23,8,6,14
42,18/02/2016,0,4,8,12
42,18/02/2016,1,2,0,2
42,18/02/2016,2,0,0,0
42,18/02/2016,3,0,0,0
42,18/02/2016,4,0,0,0
42,18/02/2016,5,1,0,1
42,18/02/2016,6,3,2,5
42,18/02/2016,7,9,32,41
42,18/02/2016,8,26,71,97
42,18/02/2016,9,22,65,87
42,18/02/2016,10,13,32,45
42,18/02/2016,11,12,23,35
42,18/02/2016,12,15,28,43
42,18/02/2016,13,12,15,27
42,18/02/2016,14,17,24,41
42,18/02/2016,15,27,23,50
42,18/02/2016,16,30,26,56
42,18/02/2016,17,80,40,120
42,18/02/2016,18,42,28,70
42,18/02/2016,19,26,21,47
42,18/02/2016,20,25,4,29
42,18/02/2016,21,16,6,22
42,18/02/2016,22,11,9,20
42,18/02/2016,23,4,6,10
42,19/02/2016,0,6,6,12
42,19/02/2016,1,3,1,4
42,19/02/2016,2,1,0,1
42,19/02/2016,3,0,0,0
42,19/02/2016,4,0,0,0
42,19/02/2016,5,0,0,0
42,19/02/2016,6,2,2,4
42,19/02/2016,7,13,29,42
42,19/02/2016,8,22,60,82
42,19/02/2016,9,19,59,78
42,19/02/2016,10,14,38,52
42,19/02/2016,11,15,21,36
42,19/02/2016,12,19,20,39
42,19/02/2016,13,13,20,33
42,19/02/2016,14,18,21,39
42,19/02/2016,15,28,12,40
42,19/02/2016,16,35,32,67
42,19/02/2016,17,65,31,96
42,19/02/2016,18,31,21,52
42,19/02/2016,19,26,22,48
42,19/02/2016,20,15,8,23
42,19/02/2016,21,15,9,24
42,19/02/2016,22,6,1,7
42,19/02/2016,23,10,8,18
42,20/02/2016,0,7,2,9
42,20/02/2016,1,4,2,6
42,20/02/2016,2,2,1,3
42,20/02/2016,3,3,1,4
42,20/02/2016,4,0,0,0
42,20/02/2016,5,1,0,1
42,20/02/2016,6,0,0,0
42,20/02/2016,7,1,7,8
42,20/02/2016,8,4,7,11
42,20/02/2016,9,6,11,17
42,20/02/2016,10,6,20,26
42,20/02/2016,11,10,19,29
42,20/02/2016,12,11,8,19
42,20/02/2016,13,13,10,23
42,20/02/2016,14,10,12,22
42,20/02/2016,15,8,10,18
42,20/02/2016,16,12,16,28
42,20/02/2016,17,23,11,34
42,20/02/2016,18,11,15,26
42,20/02/2016,19,14,7,21
42,20/02/2016,20,11,5,16
42,20/02/2016,21,4,3,7
42,20/02/2016,22,5,4,9
42,20/02/2016,23,6,3,9
42,21/02/2016,0,5,0,5
42,21/02/2016,1,4,6,10
42,21/02/2016,2,2,0,2
42,21/02/2016,3,0,0,0
42,21/02/2016,4,1,1,2
42,21/02/2016,5,1,0,1
42,21/02/2016,6,2,0,2
42,21/02/2016,7,3,2,5
42,21/02/2016,8,2,5,7
42,21/02/2016,9,4,15,19
42,21/02/2016,10,11,19,30
42,21/02/2016,11,12,21,33
42,21/02/2016,12,17,21,38
42,21/02/2016,13,13,18,31
42,21/02/2016,14,19,29,48
42,21/02/2016,15,26,8,34
42,21/02/2016,16,17,21,38
42,21/02/2016,17,25,8,33
42,21/02/2016,18,18,14,32
42,21/02/2016,19,14,11,25
42,21/02/2016,20,11,7,18
42,21/02/2016,21,4,5,9
42,21/02/2016,22,9,2,11
42,21/02/2016,23,2,4,6
42,22/02/2016,0,0,4,4
42,22/02/2016,1,2,0,2
42,22/02/2016,2,2,0,2
42,22/02/2016,3,0,0,0
42,22/02/2016,4,0,0,0
42,22/02/2016,5,0,0,0
42,22/02/2016,6,6,6,12
42,22/02/2016,7,12,39,51
42,22/02/2016,8,31,105,136
42,22/02/2016,9,20,78,98
42,22/02/2016,10,20,49,69
42,22/02/2016,11,18,34,52
42,22/02/2016,12,19,17,36
42,22/02/2016,13,32,33,65
42,22/02/2016,14,19,27,46
42,22/02/2016,15,35,28,63
42,22/02/2016,16,50,27,77
42,22/02/2016,17,103,50,153
42,22/02/2016,18,65,33,98
42,22/02/2016,19,35,23,58
42,22/02/2016,20,26,14,40
42,22/02/2016,21,21,17,38
42,22/02/2016,22,25,3,28
42,22/02/2016,23,5,2,7
42,23/02/2016,0,3,1,4
42,23/02/2016,1,1,0,1
42,23/02/2016,2,0,0,0
42,23/02/2016,3,0,0,0
42,23/02/2016,4,0,0,0
42,23/02/2016,5,1,0,1
42,23/02/2016,6,5,9,14
42,23/02/2016,7,21,44,65
42,23/02/2016,8,43,120,163
42,23/02/2016,9,23,74,97
42,23/02/2016,10,14,36,50
42,23/02/2016,11,17,28,45
42,23/02/2016,12,15,43,58
42,23/02/2016,13,37,24,61
42,23/02/2016,14,20,28,48
42,23/02/2016,15,30,35,65
42,23/02/2016,16,56,34,90
42,23/02/2016,17,113,63,176
42,23/02/2016,18,56,32,88
42,23/02/2016,19,32,27,59
42,23/02/2016,20,35,16,51
42,23/02/2016,21,25,4,29
42,23/02/2016,22,19,7,26
42,23/02/2016,23,12,6,18
42,24/02/2016,0,4,2,6
42,24/02/2016,1,1,0,1
42,24/02/2016,2,2,0,2
42,24/02/2016,3,0,0,0
42,24/02/2016,4,0,0,0
42,24/02/2016,5,0,0,0
42,24/02/2016,6,2,11,13
42,24/02/2016,7,15,30,45
42,24/02/2016,8,52,112,164
42,24/02/2016,9,22,84,106
42,24/02/2016,10,16,42,58
42,24/02/2016,11,16,33,49
42,24/02/2016,12,20,27,47
42,24/02/2016,13,24,31,55
42,24/02/2016,14,23,30,53
42,24/02/2016,15,40,22,62
42,24/02/2016,16,49,33,82
42,24/02/2016,17,83,51,134
42,24/02/2016,18,58,32,90
42,24/02/2016,19,37,22,59
42,24/02/2016,20,26,11,37
42,24/02/2016,21,17,8,25
42,24/02/2016,22,19,9,28
42,24/02/2016,23,8,4,12
42,25/02/2016,0,7,4,11
42,25/02/2016,1,5,1,6
42,25/02/2016,2,0,0,0
42,25/02/2016,3,1,0,1
42,25/02/2016,4,0,0,0
42,25/02/2016,5,0,0,0
42,25/02/2016,6,4,7,11
42,25/02/2016,7,14,36,50
42,25/02/2016,8,34,110,144
42,25/02/2016,9,24,82,106
42,25/02/2016,10,17,40,57
42,25/02/2016,11,16,29,45
42,25/02/2016,12,15,25,40
42,25/02/2016,13,28,28,56
42,25/02/2016,14,17,27,44
42,25/02/2016,15,26,13,39
42,25/02/2016,16,46,38,84
42,25/02/2016,17,104,47,151
42,25/02/2016,18,65,24,89
42,25/02/2016,19,39,23,62
42,25/02/2016,20,33,8,41
42,25/02/2016,21,27,7,34
42,25/02/2016,22,10,4,14
42,25/02/2016,23,8,5,13
42,26/02/2016,0,4,2,6
42,26/02/2016,1,0,0,0
42,26/02/2016,2,0,1,1
42,26/02/2016,3,0,0,0
42,26/02/2016,4,1,0,1
42,26/02/2016,5,1,0,1
42,26/02/2016,6,4,8,12
42,26/02/2016,7,11,32,43
42,26/02/2016,8,33,84,117
42,26/02/2016,9,21,57,78
42,26/02/2016,10,11,44,55
42,26/02/2016,11,17,23,40
42,26/02/2016,12,24,29,53
42,26/02/2016,13,25,25,50
42,26/02/2016,14,26,23,49
42,26/02/2016,15,32,15,47
42,26/02/2016,16,54,26,80
42,26/02/2016,17,73,45,118
42,26/02/2016,18,42,26,68
42,26/02/2016,19,26,33,59
42,26/02/2016,20,18,9,27
42,26/02/2016,21,11,14,25
42,26/02/2016,22,11,9,20
42,26/02/2016,23,9,14,23
42,27/02/2016,0,3,0,3
42,27/02/2016,1,3,0,3
42,27/02/2016,2,3,0,3
42,27/02/2016,3,3,0,3
42,27/02/2016,4,2,0,2
42,27/02/2016,5,2,0,2
42,27/02/2016,6,1,0,1
42,27/02/2016,7,3,3,6
42,27/02/2016,8,8,15,23
42,27/02/2016,9,10,23,33
42,27/02/2016,10,20,32,52
42,27/02/2016,11,16,34,50
42,27/02/2016,12,15,18,33
42,27/02/2016,13,19,29,48
42,27/02/2016,14,23,29,52
42,27/02/2016,15,16,15,31
42,27/02/2016,16,19,22,41
42,27/02/2016,17,30,17,47
42,27/02/2016,18,17,14,31
42,27/02/2016,19,17,14,31
42,27/02/2016,20,16,9,25
42,27/02/2016,21,5,5,10
42,27/02/2016,22,2,11,13
42,27/02/2016,23,8,4,12
42,06/03/2016,0,5,5,10
42,06/03/2016,1,6,5,11
42,06/03/2016,2,0,0,0
42,06/03/2016,3,1,1,2
42,06/03/2016,4,1,1,2
42,06/03/2016,5,1,0,1
42,06/03/2016,6,2,1,3
42,06/03/2016,7,2,4,6
42,06/03/2016,8,5,8,13
42,06/03/2016,9,11,22,33
42,06/03/2016,10,13,24,37
42,06/03/2016,11,15,33,48
42,06/03/2016,12,12,39,51
42,06/03/2016,13,16,34,50
42,06/03/2016,14,15,22,37
42,06/03/2016,15,18,21,39
42,06/03/2016,16,31,21,52
42,06/03/2016,17,27,12,39
42,06/03/2016,18,20,13,33
42,06/03/2016,19,12,8,20
42,06/03/2016,20,9,5,14
42,06/03/2016,21,13,9,22
42,06/03/2016,22,7,2,9
42,06/03/2016,23,5,3,8
42,07/03/2016,0,3,4,7
42,07/03/2016,1,3,0,3
42,07/03/2016,2,0,0,0
42,07/03/2016,3,0,0,0
42,07/03/2016,4,0,0,0
42,07/03/2016,5,0,1,1
42,07/03/2016,6,4,7,11
42,07/03/2016,7,16,31,47
42,07/03/2016,8,48,100,148
42,07/03/2016,9,25,80,105
42,07/03/2016,10,19,31,50
42,07/03/2016,11,14,27,41
42,07/03/2016,12,20,26,46
42,07/03/2016,13,28,32,60
42,07/03/2016,14,29,28,57
42,07/03/2016,15,22,30,52
42,07/03/2016,16,57,31,88
42,07/03/2016,17,96,62,158
42,07/03/2016,18,75,37,112
42,07/03/2016,19,51,34,85
42,07/03/2016,20,37,13,50
42,07/03/2016,21,28,13,41
42,07/03/2016,22,14,6,20
42,07/03/2016,23,7,3,10
42,08/03/2016,0,10,7,17
42,08/03/2016,1,3,1,4
42,08/03/2016,2,0,0,0
42,08/03/2016,3,0,0,0
42,08/03/2016,4,0,0,0
42,08/03/2016,5,0,1,1
42,08/03/2016,6,6,7,13
42,08/03/2016,7,20,36,56
42,08/03/2016,8,49,125,174
42,08/03/2016,9,29,83,112
42,08/03/2016,10,14,49,63
42,08/03/2016,11,16,29,45
42,08/03/2016,12,19,20,39
42,08/03/2016,13,20,36,56
42,08/03/2016,14,30,30,60
42,08/03/2016,15,31,23,54
42,08/03/2016,16,58,37,95
42,08/03/2016,17,91,62,153
42,08/03/2016,18,77,42,119
42,08/03/2016,19,43,22,65
42,08/03/2016,20,34,17,51
42,08/03/2016,21,23,8,31
42,08/03/2016,22,15,5,20
42,08/03/2016,23,11,7,18
42,09/03/2016,0,5,3,8
42,09/03/2016,1,1,1,2
42,09/03/2016,2,1,0,1
42,09/03/2016,3,0,1,1
42,09/03/2016,4,0,0,0
42,09/03/2016,5,0,2,2
42,09/03/2016,6,5,8,13
42,09/03/2016,7,19,35,54
42,09/03/2016,8,47,108,155
42,09/03/2016,9,24,78,102
42,09/03/2016,10,10,46,56
42,09/03/2016,11,15,37,52
42,09/03/2016,12,18,21,39
42,09/03/2016,13,28,28,56
42,09/03/2016,14,36,33,69
42,09/03/2016,15,40,26,66
42,09/03/2016,16,39,31,70
42,09/03/2016,17,87,55,142
42,09/03/2016,18,71,49,120
42,09/03/2016,19,50,31,81
42,09/03/2016,20,25,18,43
42,09/03/2016,21,20,7,27
42,09/03/2016,22,17,7,24
42,09/03/2016,23,7,7,14
42,10/03/2016,0,7,1,8
42,10/03/2016,1,8,1,9
42,10/03/2016,2,2,0,2
42,10/03/2016,3,1,1,2
42,10/03/2016,4,0,1,1
42,10/03/2016,5,1,0,1
42,10/03/2016,6,5,8,13
42,10/03/2016,7,15,41,56
42,10/03/2016,8,44,126,170
42,10/03/2016,9,26,91,117
42,10/03/2016,10,11,38,49
42,10/03/2016,11,14,23,37
42,10/03/2016,12,17,26,43
42,10/03/2016,13,27,35,62
42,10/03/2016,14,39,33,72
42,10/03/2016,15,25,39,64
42,10/03/2016,16,58,51,109
42,10/03/2016,17,99,62,161
42,10/03/2016,18,73,34,107
42,10/03/2016,19,50,22,72
42,10/03/2016,20,28,10,38
42,10/03/2016,21,25,10,35
42,10/03/2016,22,12,6,18
42,10/03/2016,23,16,6,22
42,11/03/2016,0,5,8,13
42,11/03/2016,1,4,1,5
42,11/03/2016,2,2,0,2
42,11/03/2016,3,1,1,2
42,11/03/2016,4,0,0,0
42,11/03/2016,5,0,0,0
42,11/03/2016,6,5,5,10
42,11/03/2016,7,16,47,63
42,11/03/2016,8,38,87,125
42,11/03/2016,9,23,83,106
42,11/03/2016,10,18,31,49
42,11/03/2016,11,26,34,60
42,11/03/2016,12,29,27,56
42,11/03/2016,13,25,18,43
42,11/03/2016,14,22,19,41
42,11/03/2016,15,38,25,63
42,11/03/2016,16,36,42,78
42,11/03/2016,17,77,41,118
42,11/03/2016,18,46,32,78
42,11/03/2016,19,36,20,56
42,11/03/2016,20,28,16,44
42,11/03/2016,21,20,10,30
42,11/03/2016,22,11,6,17
42,11/03/2016,23,10,7,17
42,12/03/2016,0,15,5,20
42,12/03/2016,1,2,4,6
42,12/03/2016,2,2,0,2
42,12/03/2016,3,3,0,3
42,12/03/2016,4,1,1,2
42,12/03/2016,5,2,0,2
42,12/03/2016,6,1,2,3
42,12/03/2016,7,4,11,15
42,12/03/2016,8,10,15,25
42,12/03/2016,9,8,28,36
42,12/03/2016,10,27,40,67
42,12/03/2016,11,23,23,46
42,12/03/2016,12,24,26,50
42,12/03/2016,13,29,33,62
42,12/03/2016,14,15,43,58
42,12/03/2016,15,22,35,57
42,12/03/2016,16,27,21,48
42,12/03/2016,17,35,37,72
42,12/03/2016,18,30,11,41
42,12/03/2016,19,23,21,44
42,12/03/2016,20,14,10,24
42,12/03/2016,21,14,8,22
42,12/03/2016,22,11,10,21
42,12/03/2016,23,11,5,16
42,13/03/2016,0,4,5,9
42,13/03/2016,1,5,4,9
42,13/03/2016,2,1,2,3
42,13/03/2016,3,3,0,3
42,13/03/2016,4,0,0,0
42,13/03/2016,5,2,0,2
42,13/03/2016,6,3,1,4
42,13/03/2016,7,1,7,8
42,13/03/2016,8,4,13,17
42,13/03/2016,9,14,22,36
42,13/03/2016,10,32,33,65
42,13/03/2016,11,25,34,59
42,13/03/2016,12,22,27,49
42,13/03/2016,13,33,35,68
42,13/03/2016,14,28,33,61
42,13/03/2016,15,27,21,48
42,13/03/2016,16,35,19,54
42,13/03/2016,17,41,24,65
42,13/03/2016,18,20,17,37
42,13/03/2016,19,19,10,29
42,13/03/2016,20,15,10,25
42,13/03/2016,21,14,9,23
42,13/03/2016,22,6,6,12
42,13/03/2016,23,12,6,18
42,14/03/2016,0,8,1,9
42,14/03/2016,1,3,1,4
42,14/03/2016,2,6,0,6
42,14/03/2016,3,0,0,0
42,14/03/2016,4,0,0,0
42,14/03/2016,5,2,1,3
42,14/03/2016,6,6,8,14
42,14/03/2016,7,21,48,69
42,14/03/2016,8,51,117,168
42,14/03/2016,9,24,93,117
42,14/03/2016,10,11,40,51
42,14/03/2016,11,23,33,56
42,14/03/2016,12,21,29,50
42,14/03/2016,13,34,39,73
42,14/03/2016,14,30,33,63
42,14/03/2016,15,40,39,79
42,14/03/2016,16,73,46,119
42,14/03/2016,17,124,85,209
42,14/03/2016,18,86,47,133
42,14/03/2016,19,56,35,91
42,14/03/2016,20,30,18,48
42,14/03/2016,21,26,12,38
42,14/03/2016,22,15,7,22
42,14/03/2016,23,7,5,12
42,15/03/2016,0,6,5,11
42,15/03/2016,1,5,1,6
42,15/03/2016,2,1,1,2
42,15/03/2016,3,0,0,0
42,15/03/2016,4,0,0,0
42,15/03/2016,5,1,0,1
42,15/03/2016,6,11,12,23
42,15/03/2016,7,15,39,54
42,15/03/2016,8,40,130,170
42,15/03/2016,9,30,96,126
42,15/03/2016,10,16,46,62
42,15/03/2016,11,21,29,50
42,15/03/2016,12,25,32,57
42,15/03/2016,13,29,34,63
42,15/03/2016,14,16,28,44
42,15/03/2016,15,47,21,68
42,15/03/2016,16,55,42,97
42,15/03/2016,17,92,66,158
42,15/03/2016,18,74,31,105
42,15/03/2016,19,42,23,65
42,15/03/2016,20,27,10,37
42,15/03/2016,21,24,14,38
42,15/03/2016,22,8,5,13
42,15/03/2016,23,10,2,12
42,16/03/2016,0,2,0,2
42,16/03/2016,1,2,0,2
42,16/03/2016,2,6,0,6
42,16/03/2016,3,1,1,2
42,16/03/2016,4,2,2,4
42,16/03/2016,5,2,1,3
42,16/03/2016,6,4,11,15
42,16/03/2016,7,15,39,54
42,16/03/2016,8,54,116,170
42,16/03/2016,9,21,76,97
42,16/03/2016,10,9,57,66
42,16/03/2016,11,12,29,41
42,16/03/2016,12,22,26,48
42,16/03/2016,13,31,34,65
42,16/03/2016,14,25,22,47
42,16/03/2016,15,36,26,62
42,16/03/2016,16,47,48,95
42,16/03/2016,17,82,72,154
42,16/03/2016,18,68,56,124
42,16/03/2016,19,46,22,68
42,16/03/2016,20,48,17,65
42,16/03/2016,21,21,9,30
42,16/03/2016,22,19,12,31
42,16/03/2016,23,14,4,18
42,17/03/2016,0,7,3,10
42,17/03/2016,1,4,1,5
42,17/03/2016,2,4,1,5
42,17/03/2016,3,0,0,0
42,17/03/2016,4,0,0,0
42,17/03/2016,5,2,0,2
42,17/03/2016,6,8,9,17
42,17/03/2016,7,13,43,56
42,17/03/2016,8,45,122,167
42,17/03/2016,9,21,89,110
42,17/03/2016,10,15,39,54
42,17/03/2016,11,17,32,49
42,17/03/2016,12,13,19,32
42,17/03/2016,13,23,35,58
42,17/03/2016,14,32,32,64
42,17/03/2016,15,38,20,58
42,17/03/2016,16,70,53,123
42,17/03/2016,17,101,56,157
42,17/03/2016,18,69,27,96
42,17/03/2016,19,40,27,67
42,17/03/2016,20,37,13,50
42,17/03/2016,21,19,10,29
42,17/03/2016,22,12,10,22
42,17/03/2016,23,6,4,10
42,18/03/2016,0,4,3,7
42,18/03/2016,1,3,1,4
42,18/03/2016,2,3,0,3
42,18/03/2016,3,1,1,2
42,18/03/2016,4,0,1,1
42,18/03/2016,5,1,1,2
42,18/03/2016,6,6,13,19
42,18/03/2016,7,17,32,49
42,18/03/2016,8,41,94,135
42,18/03/2016,9,24,76,100
42,18/03/2016,10,20,45,65
42,18/03/2016,11,16,30,46
42,18/03/2016,12,26,29,55
42,18/03/2016,13,31,25,56
42,18/03/2016,14,24,27,51
42,18/03/2016,15,37,39,76
42,18/03/2016,16,53,29,82
42,18/03/2016,17,76,40,116
42,18/03/2016,18,57,35,92
42,18/03/2016,19,24,15,39
42,18/03/2016,20,23,11,34
42,18/03/2016,21,18,12,30
42,18/03/2016,22,17,6,23
42,18/03/2016,23,12,8,20
42,19/03/2016,0,3,7,10
42,19/03/2016,1,7,7,14
42,19/03/2016,2,3,2,5
42,19/03/2016,3,1,1,2
42,19/03/2016,4,0,3,3
42,19/03/2016,5,3,0,3
42,19/03/2016,6,1,1,2
42,19/03/2016,7,2,8,10
42,19/03/2016,8,9,15,24
42,19/03/2016,9,13,22,35
42,19/03/2016,10,21,35,56
42,19/03/2016,11,23,35,58
42,19/03/2016,12,23,30,53
42,19/03/2016,13,29,35,64
42,19/03/2016,14,36,40,76
42,19/03/2016,15,32,50,82
42,19/03/2016,16,50,33,83
42,19/03/2016,17,41,24,65
42,19/03/2016,18,30,19,49
42,19/03/2016,19,24,13,37
42,19/03/2016,20,18,8,26
42,19/03/2016,21,8,8,16
42,19/03/2016,22,14,12,26
42,19/03/2016,23,8,8,16
42,20/03/2016,0,8,4,12
42,20/03/2016,1,4,2,6
42,20/03/2016,2,1,3,4
42,20/03/2016,3,2,1,3
42,20/03/2016,4,2,0,2
42,20/03/2016,5,1,0,1
42,20/03/2016,6,2,0,2
42,20/03/2016,7,4,5,9
42,20/03/2016,8,10,11,21
42,20/03/2016,9,14,26,40
42,20/03/2016,10,30,35,65
42,20/03/2016,11,22,41,63
42,20/03/2016,12,35,36,71
42,20/03/2016,13,37,47,84
42,20/03/2016,14,37,37,74
42,20/03/2016,15,31,43,74
42,20/03/2016,16,37,39,76
42,20/03/2016,17,40,25,65
42,20/03/2016,18,34,14,48
42,20/03/2016,19,19,13,32
42,20/03/2016,20,17,10,27
42,20/03/2016,21,11,11,22
42,20/03/2016,22,20,7,27
42,20/03/2016,23,7,5,12
42,21/03/2016,0,5,4,9
42,21/03/2016,1,3,1,4
42,21/03/2016,2,1,0,1
42,21/03/2016,3,0,1,1
42,21/03/2016,4,0,0,0
42,21/03/2016,5,0,1,1
42,21/03/2016,6,7,8,15
42,21/03/2016,7,17,41,58
42,21/03/2016,8,43,115,158
42,21/03/2016,9,28,91,119
42,21/03/2016,10,24,51,75
42,21/03/2016,11,13,35,48
42,21/03/2016,12,24,24,48
42,21/03/2016,13,24,35,59
42,21/03/2016,14,29,24,53
42,21/03/2016,15,38,32,70
42,21/03/2016,16,49,38,87
42,21/03/2016,17,105,56,161
42,21/03/2016,18,67,45,112
42,21/03/2016,19,50,28,78
42,21/03/2016,20,37,15,52
42,21/03/2016,21,25,11,36
42,21/03/2016,22,18,6,24
42,21/03/2016,23,6,4,10
42,22/03/2016,0,12,3,15
42,22/03/2016,1,0,0,0
42,22/03/2016,2,1,1,2
42,22/03/2016,3,0,0,0
42,22/03/2016,4,0,0,0
42,22/03/2016,5,0,1,1
42,22/03/2016,6,7,12,19
42,22/03/2016,7,23,54,77
42,22/03/2016,8,46,140,186
42,22/03/2016,9,22,102,124
42,22/03/2016,10,15,43,58
42,22/03/2016,11,13,31,44
42,22/03/2016,12,22,27,49
42,22/03/2016,13,30,28,58
42,22/03/2016,14,24,36,60
42,22/03/2016,15,44,25,69
42,22/03/2016,16,67,40,107
42,22/03/2016,17,120,75,195
42,22/03/2016,18,61,39,100
42,22/03/2016,19,49,30,79
42,22/03/2016,20,43,22,65
42,22/03/2016,21,31,12,43
42,22/03/2016,22,18,5,23
42,22/03/2016,23,8,4,12
42,23/03/2016,0,10,1,11
42,23/03/2016,1,4,2,6
42,23/03/2016,2,3,1,4
42,23/03/2016,3,2,0,2
42,23/03/2016,4,0,0,0
42,23/03/2016,5,1,0,1
42,23/03/2016,6,3,16,19
42,23/03/2016,7,31,52,83
42,23/03/2016,8,63,129,192
42,23/03/2016,9,23,92,115
42,23/03/2016,10,18,46,64
42,23/03/2016,11,19,21,40
42,23/03/2016,12,25,34,59
42,23/03/2016,13,30,33,63
42,23/03/2016,14,29,27,56
42,23/03/2016,15,39,22,61
42,23/03/2016,16,50,43,93
42,23/03/2016,17,103,73,176
42,23/03/2016,18,63,58,121
42,23/03/2016,19,55,26,81
42,23/03/2016,20,28,17,45
42,23/03/2016,21,19,12,31
42,23/03/2016,22,23,9,32
42,23/03/2016,23,14,5,19
42,24/03/2016,0,4,4,8
42,24/03/2016,1,2,3,5
42,24/03/2016,2,3,0,3
42,24/03/2016,3,1,0,1
42,24/03/2016,4,0,0,0
42,24/03/2016,5,0,2,2
42,24/03/2016,6,2,10,12
42,24/03/2016,7,16,32,48
42,24/03/2016,8,36,128,164
42,24/03/2016,9,20,84,104
42,24/03/2016,10,17,37,54
42,24/03/2016,11,26,23,49
42,24/03/2016,12,20,19,39
42,24/03/2016,13,21,42,63
42,24/03/2016,14,24,34,58
42,24/03/2016,15,42,23,65
42,24/03/2016,16,63,31,94
42,24/03/2016,17,92,45,137
42,24/03/2016,18,64,46,110
42,24/03/2016,19,44,25,69
42,24/03/2016,20,38,11,49
42,24/03/2016,21,36,6,42
42,24/03/2016,22,11,4,15
42,24/03/2016,23,12,8,20
42,25/03/2016,0,5,5,10
42,25/03/2016,1,6,2,8
42,25/03/2016,2,1,4,5
42,25/03/2016,3,1,1,2
42,25/03/2016,4,0,0,0
42,25/03/2016,5,2,0,2
42,25/03/2016,6,3,5,8
42,25/03/2016,7,4,29,33
42,25/03/2016,8,18,69,87
42,25/03/2016,9,18,52,70
42,25/03/2016,10,25,43,68
42,25/03/2016,11,23,45,68
42,25/03/2016,12,26,37,63
42,25/03/2016,13,38,34,72
42,25/03/2016,14,41,30,71
42,25/03/2016,15,50,47,97
42,25/03/2016,16,47,29,76
42,25/03/2016,17,45,34,79
42,25/03/2016,18,48,27,75
42,25/03/2016,19,28,17,45
42,25/03/2016,20,30,17,47
42,25/03/2016,21,11,7,18
42,25/03/2016,22,16,4,20
42,25/03/2016,23,13,6,19
42,26/03/2016,0,6,5,11
42,26/03/2016,1,4,0,4
42,26/03/2016,2,7,4,11
42,26/03/2016,3,3,0,3
42,26/03/2016,4,1,0,1
42,26/03/2016,5,0,0,0
42,26/03/2016,6,0,1,1
42,26/03/2016,7,4,6,10
42,26/03/2016,8,5,14,19
42,26/03/2016,9,7,21,28
42,26/03/2016,10,15,25,40
42,26/03/2016,11,12,14,26
42,26/03/2016,12,24,21,45
42,26/03/2016,13,11,18,29
42,26/03/2016,14,16,18,34
42,26/03/2016,15,9,19,28
42,26/03/2016,16,25,17,42
42,26/03/2016,17,18,20,38
42,26/03/2016,18,28,13,41
42,26/03/2016,19,18,19,37
42,26/03/2016,20,10,5,15
42,26/03/2016,21,10,8,18
42,26/03/2016,22,10,9,19
42,26/03/2016,23,8,5,13
42,27/03/2016,0,7,1,8
42,27/03/2016,1,8,1,9
42,27/03/2016,2,0,2,2
42,27/03/2016,3,1,3,4
42,27/03/2016,4,1,0,1
42,27/03/2016,5,0,1,1
42,27/03/2016,6,0,0,0
42,27/03/2016,7,2,4,6
42,27/03/2016,8,3,7,10
42,27/03/2016,9,9,17,26
42,27/03/2016,10,6,19,25
42,27/03/2016,11,4,18,22
42,27/03/2016,12,9,19,28
42,27/03/2016,13,12,10,22
42,27/03/2016,14,10,18,28
42,27/03/2016,15,13,21,34
42,27/03/2016,16,13,19,32
42,27/03/2016,17,23,10,33
42,27/03/2016,18,26,14,40
42,27/03/2016,19,16,2,18
42,27/03/2016,20,10,9,19
42,27/03/2016,21,9,9,18
42,27/03/2016,22,9,5,14
42,27/03/2016,23,10,1,11
42,28/03/2016,0,3,7,10
42,28/03/2016,1,1,0,1
42,28/03/2016,2,1,0,1
42,28/03/2016,3,3,0,3
42,28/03/2016,4,1,1,2
42,28/03/2016,5,1,2,3
42,28/03/2016,6,0,4,4
42,28/03/2016,7,6,20,26
42,28/03/2016,8,23,54,77
42,28/03/2016,9,6,53,59
42,28/03/2016,10,5,40,45
42,28/03/2016,11,11,28,39
42,28/03/2016,12,15,36,51
42,28/03/2016,13,23,32,55
42,28/03/2016,14,29,39,68
42,28/03/2016,15,35,25,60
42,28/03/2016,16,50,32,82
42,28/03/2016,17,79,41,120
42,28/03/2016,18,55,31,86
42,28/03/2016,19,37,25,62
42,28/03/2016,20,29,16,45
42,28/03/2016,21,23,2,25
42,28/03/2016,22,17,10,27
42,28/03/2016,23,7,3,10
42,29/03/2016,0,4,3,7
42,29/03/2016,1,3,1,4
42,29/03/2016,2,0,0,0
42,29/03/2016,3,0,0,0
42,29/03/2016,4,0,0,0
42,29/03/2016,5,0,0,0
42,29/03/2016,6,5,9,14
42,29/03/2016,7,20,41,61
42,29/03/2016,8,40,93,133
42,29/03/2016,9,20,103,123
42,29/03/2016,10,11,41,52
42,29/03/2016,11,22,41,63
42,29/03/2016,12,20,22,42
42,29/03/2016,13,23,34,57
42,29/03/2016,14,25,22,47
42,29/03/2016,15,29,16,45
42,29/03/2016,16,54,35,89
42,29/03/2016,17,110,48,158
42,29/03/2016,18,82,39,121
42,29/03/2016,19,42,29,71
42,29/03/2016,20,39,24,63
42,29/03/2016,21,18,10,28
42,29/03/2016,22,18,4,22
42,29/03/2016,23,16,3,19
42,30/03/2016,0,7,5,12
42,30/03/2016,1,3,0,3
42,30/03/2016,2,3,1,4
42,30/03/2016,3,0,0,0
42,30/03/2016,4,0,2,2
42,30/03/2016,5,1,1,2
42,30/03/2016,6,5,7,12
42,30/03/2016,7,15,46,61
42,30/03/2016,8,44,105,149
42,30/03/2016,9,24,84,108
42,30/03/2016,10,17,47,64
42,30/03/2016,11,27,36,63
42,30/03/2016,12,24,22,46
42,30/03/2016,13,20,36,56
42,30/03/2016,14,17,30,47
42,30/03/2016,15,36,27,63
42,30/03/2016,16,50,29,79
42,30/03/2016,17,92,59,151
42,30/03/2016,18,75,44,119
42,30/03/2016,19,46,27,73
42,30/03/2016,20,25,9,34
42,30/03/2016,21,22,12,34
42,30/03/2016,22,18,6,24
42,30/03/2016,23,11,5,16
42,31/03/2016,0,9,7,16
42,31/03/2016,1,2,1,3
42,31/03/2016,2,4,1,5
42,31/03/2016,3,1,0,1
42,31/03/2016,4,0,0,0
42,31/03/2016,5,2,2,4
42,31/03/2016,6,6,11,17
42,31/03/2016,7,17,35,52
42,31/03/2016,8,35,102,137
42,31/03/2016,9,18,76,94
42,31/03/2016,10,21,60,81
42,31/03/2016,11,22,22,44
42,31/03/2016,12,26,22,48
42,31/03/2016,13,26,28,54
42,31/03/2016,14,21,30,51
42,31/03/2016,15,29,23,52
42,31/03/2016,16,40,27,67
42,31/03/2016,17,94,63,157
42,31/03/2016,18,61,31,92
42,31/03/2016,19,46,30,76
42,31/03/2016,20,34,6,40
42,31/03/2016,21,20,18,38
42,31/03/2016,22,12,13,25
42,31/03/2016,23,8,6,14
42,01/04/2016,0,6,3,9
42,01/04/2016,1,7,7,14
42,01/04/2016,2,1,1,2
42,01/04/2016,3,0,0,0
42,01/04/2016,4,0,0,0
42,01/04/2016,5,2,3,5
42,01/04/2016,6,3,9,12
42,01/04/2016,7,12,25,37
42,01/04/2016,8,31,84,115
42,01/04/2016,9,18,58,76
42,01/04/2016,10,12,26,38
42,01/04/2016,11,14,22,36
42,01/04/2016,12,16,32,48
42,01/04/2016,13,28,27,55
42,01/04/2016,14,26,24,50
42,01/04/2016,15,31,32,63
42,01/04/2016,16,36,27,63
42,01/04/2016,17,56,35,91
42,01/04/2016,18,45,25,70
42,01/04/2016,19,28,23,51
42,01/04/2016,20,21,11,32
42,01/04/2016,21,20,9,29
42,01/04/2016,22,13,6,19
42,01/04/2016,23,7,5,12
42,02/04/2016,0,8,1,9
42,02/04/2016,1,2,2,4
42,02/04/2016,2,6,1,7
42,02/04/2016,3,1,0,1
42,02/04/2016,4,2,1,3
42,02/04/2016,5,2,0,2
42,02/04/2016,6,0,2,2
42,02/04/2016,7,2,5,7
42,02/04/2016,8,1,6,7
42,02/04/2016,9,11,24,35
42,02/04/2016,10,12,22,34
42,02/04/2016,11,15,16,31
42,02/04/2016,12,32,31,63
42,02/04/2016,13,33,23,56
42,02/04/2016,14,22,26,48
42,02/04/2016,15,24,18,42
42,02/04/2016,16,20,10,30
42,02/04/2016,17,28,21,49
42,02/04/2016,18,28,8,36
42,02/04/2016,19,16,15,31
42,02/04/2016,20,11,8,19
42,02/04/2016,21,8,5,13
42,02/04/2016,22,10,9,19
42,02/04/2016,23,6,9,15
42,03/04/2016,0,1,4,5
42,03/04/2016,1,3,2,5
42,03/04/2016,2,1,2,3
42,03/04/2016,3,0,0,0
42,03/04/2016,4,1,0,1
42,03/04/2016,5,1,0,1
42,03/04/2016,6,2,1,3
42,03/04/2016,7,0,0,0
42,03/04/2016,8,4,4,8
42,03/04/2016,9,9,20,29
42,03/04/2016,10,11,23,34
42,03/04/2016,11,11,26,37
42,03/04/2016,12,16,14,30
42,03/04/2016,13,16,12,28
42,03/04/2016,14,21,25,46
42,03/04/2016,15,15,24,39
42,03/04/2016,16,33,16,49
42,03/04/2016,17,20,23,43
42,03/04/2016,18,28,17,45
42,03/04/2016,19,28,11,39
42,03/04/2016,20,18,11,29
42,03/04/2016,21,14,5,19
42,03/04/2016,22,5,4,9
42,03/04/2016,23,4,5,9
42,04/04/2016,0,5,4,9
42,04/04/2016,1,1,1,2
42,04/04/2016,2,1,0,1
42,04/04/2016,3,0,0,0
42,04/04/2016,4,0,0,0
42,04/04/2016,5,1,1,2
42,04/04/2016,6,5,7,12
42,04/04/2016,7,17,27,44
42,04/04/2016,8,30,52,82
42,04/04/2016,9,18,44,62
42,04/04/2016,10,12,40,52
42,04/04/2016,11,12,17,29
42,04/04/2016,12,6,11,17
42,04/04/2016,13,15,14,29
42,04/04/2016,14,15,11,26
42,04/04/2016,15,17,12,29
42,04/04/2016,16,25,14,39
42,04/04/2016,17,64,45,109
42,04/04/2016,18,42,21,63
42,04/04/2016,19,31,15,46
42,04/04/2016,20,10,8,18
42,04/04/2016,21,13,1,14
42,04/04/2016,22,11,6,17
42,04/04/2016,23,10,1,11
42,05/04/2016,0,3,2,5
42,05/04/2016,1,1,1,2
42,05/04/2016,2,0,1,1
42,05/04/2016,3,0,1,1
42,05/04/2016,4,0,0,0
42,05/04/2016,5,0,2,2
42,05/04/2016,6,8,9,17
42,05/04/2016,7,16,22,38
42,05/04/2016,8,41,75,116
42,05/04/2016,9,16,69,85
42,05/04/2016,10,9,25,34
42,05/04/2016,11,6,24,30
42,05/04/2016,12,18,20,38
42,05/04/2016,13,23,17,40
42,05/04/2016,14,15,18,33
42,05/04/2016,15,17,12,29
42,05/04/2016,16,30,31,61
42,05/04/2016,17,70,55,125
42,05/04/2016,18,50,40,90
42,05/04/2016,19,35,29,64
42,05/04/2016,20,34,16,50
42,05/04/2016,21,25,6,31
42,05/04/2016,22,10,6,16
42,05/04/2016,23,8,2,10
42,06/04/2016,0,6,4,10
42,06/04/2016,1,5,4,9
42,06/04/2016,2,1,0,1
42,06/04/2016,3,0,0,0
42,06/04/2016,4,1,1,2
42,06/04/2016,5,0,0,0
42,06/04/2016,6,7,12,19
42,06/04/2016,7,14,23,37
42,06/04/2016,8,34,77,111
42,06/04/2016,9,22,66,88
42,06/04/2016,10,13,38,51
42,06/04/2016,11,6,30,36
42,06/04/2016,12,12,31,43
42,06/04/2016,13,25,18,43
42,06/04/2016,14,12,27,39
42,06/04/2016,15,30,29,59
42,06/04/2016,16,34,36,70
42,06/04/2016,17,77,50,127
42,06/04/2016,18,67,28,95
42,06/04/2016,19,38,22,60
42,06/04/2016,20,29,25,54
42,06/04/2016,21,14,11,25
42,06/04/2016,22,12,11,23
42,06/04/2016,23,8,3,11
42,07/04/2016,0,7,2,9
42,07/04/2016,1,1,0,1
42,07/04/2016,2,1,1,2
42,07/04/2016,3,0,2,2
42,07/04/2016,4,0,1,1
42,07/04/2016,5,1,1,2
42,07/04/2016,6,5,9,14
42,07/04/2016,7,23,31,54
42,07/04/2016,8,38,89,127
42,07/04/2016,9,18,66,84
42,07/04/2016,10,20,31,51
42,07/04/2016,11,8,22,30
42,07/04/2016,12,22,28,50
42,07/04/2016,13,22,28,50
42,07/04/2016,14,20,20,40
42,07/04/2016,15,19,17,36
42,07/04/2016,16,38,31,69
42,07/04/2016,17,75,39,114
42,07/04/2016,18,79,25,104
42,07/04/2016,19,26,23,49
42,07/04/2016,20,19,15,34
42,07/04/2016,21,17,5,22
42,07/04/2016,22,17,7,24
42,07/04/2016,23,12,5,17
42,08/04/2016,0,2,2,4
42,08/04/2016,1,1,1,2
42,08/04/2016,2,0,1,1
42,08/04/2016,3,2,0,2
42,08/04/2016,4,1,0,1
42,08/04/2016,5,1,0,1
42,08/04/2016,6,4,2,6
42,08/04/2016,7,10,30,40
42,08/04/2016,8,30,79,109
42,08/04/2016,9,17,56,73
42,08/04/2016,10,15,33,48
42,08/04/2016,11,12,28,40
42,08/04/2016,12,10,30,40
42,08/04/2016,13,34,32,66
42,08/04/2016,14,22,25,47
42,08/04/2016,15,19,30,49
42,08/04/2016,16,49,29,78
42,08/04/2016,17,73,32,105
42,08/04/2016,18,55,24,79
42,08/04/2016,19,34,22,56
42,08/04/2016,20,23,8,31
42,08/04/2016,21,20,11,31
42,08/04/2016,22,13,4,17
42,08/04/2016,23,7,3,10
42,09/04/2016,0,5,1,6
42,09/04/2016,1,3,2,5
42,09/04/2016,2,0,2,2
42,09/04/2016,3,0,2,2
42,09/04/2016,4,1,1,2
42,09/04/2016,5,0,1,1
42,09/04/2016,6,1,3,4
42,09/04/2016,7,3,5,8
42,09/04/2016,8,8,18,26
42,09/04/2016,9,6,28,34
42,09/04/2016,10,13,35,48
42,09/04/2016,11,27,38,65
42,09/04/2016,12,29,31,60
42,09/04/2016,13,21,17,38
42,09/04/2016,14,26,35,61
42,09/04/2016,15,40,32,72
42,09/04/2016,16,28,27,55
42,09/04/2016,17,47,20,67
42,09/04/2016,18,17,21,38
42,09/04/2016,19,16,14,30
42,09/04/2016,20,19,6,25
42,09/04/2016,21,11,4,15
42,09/04/2016,22,10,9,19
42,09/04/2016,23,2,11,13
42,10/04/2016,0,9,5,14
42,10/04/2016,1,3,0,3
42,10/04/2016,2,3,1,4
42,10/04/2016,3,1,0,1
42,10/04/2016,4,0,0,0
42,10/04/2016,5,0,1,1
42,10/04/2016,6,1,4,5
42,10/04/2016,7,0,4,4
42,10/04/2016,8,4,9,13
42,10/04/2016,9,7,28,35
42,10/04/2016,10,19,46,65
42,10/04/2016,11,17,24,41
42,10/04/2016,12,21,19,40
42,10/04/2016,13,19,27,46
42,10/04/2016,14,32,23,55
42,10/04/2016,15,23,21,44
42,10/04/2016,16,28,21,49
42,10/04/2016,17,38,20,58
42,10/04/2016,18,31,26,57
42,10/04/2016,19,22,16,38
42,10/04/2016,20,9,13,22
42,10/04/2016,21,10,5,15
42,10/04/2016,22,3,3,6
42,10/04/2016,23,7,7,14
42,11/04/2016,0,3,2,5
42,11/04/2016,1,0,0,0
42,11/04/2016,2,3,0,3
42,11/04/2016,3,0,0,0
42,11/04/2016,4,0,0,0
42,11/04/2016,5,0,0,0
42,11/04/2016,6,4,11,15
42,11/04/2016,7,28,42,70
42,11/04/2016,8,50,113,163
42,11/04/2016,9,28,76,104
42,11/04/2016,10,12,34,46
42,11/04/2016,11,23,20,43
42,11/04/2016,12,20,11,31
42,11/04/2016,13,26,17,43
42,11/04/2016,14,18,18,36
42,11/04/2016,15,27,21,48
42,11/04/2016,16,40,33,73
42,11/04/2016,17,93,62,155
42,11/04/2016,18,66,52,118
42,11/04/2016,19,43,31,74
42,11/04/2016,20,37,14,51
42,11/04/2016,21,13,6,19
42,11/04/2016,22,15,3,18
42,11/04/2016,23,8,5,13
42,12/04/2016,0,2,3,5
42,12/04/2016,1,1,2,3
42,12/04/2016,2,0,1,1
42,12/04/2016,3,0,0,0
42,12/04/2016,4,0,0,0
42,12/04/2016,5,0,2,2
42,12/04/2016,6,4,11,15
42,12/04/2016,7,17,44,61
42,12/04/2016,8,50,105,155
42,12/04/2016,9,17,62,79
42,12/04/2016,10,7,27,34
42,12/04/2016,11,9,13,22
42,12/04/2016,12,8,10,18
42,12/04/2016,13,12,10,22
42,12/04/2016,14,12,9,21
42,12/04/2016,15,22,12,34
42,12/04/2016,16,29,18,47
42,12/04/2016,17,82,47,129
42,12/04/2016,18,47,33,80
42,12/04/2016,19,35,19,54
42,12/04/2016,20,19,14,33
42,12/04/2016,21,16,7,23
42,12/04/2016,22,10,5,15
42,12/04/2016,23,7,2,9
42,13/04/2016,0,4,1,5
42,13/04/2016,1,4,0,4
42,13/04/2016,2,1,0,1
42,13/04/2016,3,0,0,0
42,13/04/2016,4,0,0,0
42,13/04/2016,5,0,1,1
42,13/04/2016,6,1,13,14
42,13/04/2016,7,13,36,49
42,13/04/2016,8,29,84,113
42,13/04/2016,9,21,77,98
42,13/04/2016,10,7,23,30
42,13/04/2016,11,6,17,23
42,13/04/2016,12,16,12,28
42,13/04/2016,13,16,22,38
42,13/04/2016,14,17,17,34
42,13/04/2016,15,23,23,46
42,13/04/2016,16,34,17,51
42,13/04/2016,17,77,50,127
42,13/04/2016,18,52,33,85
42,13/04/2016,19,34,17,51
42,13/04/2016,20,23,9,32
42,13/04/2016,21,19,5,24
42,13/04/2016,22,14,2,16
42,13/04/2016,23,10,4,14
42,14/04/2016,0,7,5,12
42,14/04/2016,1,1,1,2
42,14/04/2016,2,1,0,1
42,14/04/2016,3,1,1,2
42,14/04/2016,4,0,0,0
42,14/04/2016,5,1,1,2
42,14/04/2016,6,3,10,13
42,14/04/2016,7,19,45,64
42,14/04/2016,8,57,97,154
42,14/04/2016,9,26,79,105
42,14/04/2016,10,16,31,47
42,14/04/2016,11,12,28,40
42,14/04/2016,12,21,31,52
42,14/04/2016,13,20,28,48
42,14/04/2016,14,33,27,60
42,14/04/2016,15,45,28,73
42,14/04/2016,16,49,40,89
42,14/04/2016,17,88,63,151
42,14/04/2016,18,74,58,132
42,14/04/2016,19,50,35,85
42,14/04/2016,20,31,9,40
42,14/04/2016,21,23,21,44
42,14/04/2016,22,18,9,27
42,14/04/2016,23,11,5,16
42,15/04/2016,0,4,8,12
42,15/04/2016,1,4,0,4
42,15/04/2016,2,3,0,3
42,15/04/2016,3,0,1,1
42,15/04/2016,4,1,1,2
42,15/04/2016,5,1,3,4
42,15/04/2016,6,3,12,15
42,15/04/2016,7,16,45,61
42,15/04/2016,8,37,87,124
42,15/04/2016,9,21,69,90
42,15/04/2016,10,13,33,46
42,15/04/2016,11,6,24,30
42,15/04/2016,12,23,23,46
42,15/04/2016,13,16,17,33
42,15/04/2016,14,16,22,38
42,15/04/2016,15,27,17,44
42,15/04/2016,16,38,26,64
42,15/04/2016,17,71,40,111
42,15/04/2016,18,53,35,88
42,15/04/2016,19,31,24,55
42,15/04/2016,20,21,10,31
42,15/04/2016,21,19,11,30
42,15/04/2016,22,14,9,23
42,15/04/2016,23,6,5,11
42,16/04/2016,0,2,3,5
42,16/04/2016,1,3,1,4
42,16/04/2016,2,1,1,2
42,16/04/2016,3,3,2,5
42,16/04/2016,4,1,0,1
42,16/04/2016,5,0,2,2
42,16/04/2016,6,1,1,2
42,16/04/2016,7,7,9,16
42,16/04/2016,8,8,23,31
42,16/04/2016,9,17,31,48
42,16/04/2016,10,23,40,63
42,16/04/2016,11,23,38,61
42,16/04/2016,12,16,21,37
42,16/04/2016,13,20,27,47
42,16/04/2016,14,20,27,47
42,16/04/2016,15,21,26,47
42,16/04/2016,16,38,23,61
42,16/04/2016,17,24,18,42
42,16/04/2016,18,26,17,43
42,16/04/2016,19,19,18,37
42,16/04/2016,20,18,17,35
42,16/04/2016,21,7,8,15
42,16/04/2016,22,10,5,15
42,16/04/2016,23,10,6,16
42,17/04/2016,0,3,3,6
42,17/04/2016,1,3,2,5
42,17/04/2016,2,0,0,0
42,17/04/2016,3,2,1,3
42,17/04/2016,4,1,1,2
42,17/04/2016,5,3,2,5
42,17/04/2016,6,1,1,2
42,17/04/2016,7,4,6,10
42,17/04/2016,8,10,9,19
42,17/04/2016,9,11,20,31
42,17/04/2016,10,24,21,45
42,17/04/2016,11,17,13,30
42,17/04/2016,12,20,17,37
42,17/04/2016,13,25,22,47
42,17/04/2016,14,24,24,48
42,17/04/2016,15,16,30,46
42,17/04/2016,16,28,28,56
42,17/04/2016,17,26,25,51
42,17/04/2016,18,25,27,52
42,17/04/2016,19,33,21,54
42,17/04/2016,20,19,11,30
42,17/04/2016,21,8,5,13
42,17/04/2016,22,11,5,16
42,17/04/2016,23,5,7,12
42,18/04/2016,0,3,1,4
42,18/04/2016,1,3,1,4
42,18/04/2016,2,1,0,1
42,18/04/2016,3,2,0,2
42,18/04/2016,4,0,0,0
42,18/04/2016,5,0,3,3
42,18/04/2016,6,3,9,12
42,18/04/2016,7,23,43,66
42,18/04/2016,8,33,109,142
42,18/04/2016,9,21,74,95
42,18/04/2016,10,18,43,61
42,18/04/2016,11,17,19,36
42,18/04/2016,12,19,19,38
42,18/04/2016,13,37,30,67
42,18/04/2016,14,27,24,51
42,18/04/2016,15,34,20,54
42,18/04/2016,16,54,38,92
42,18/04/2016,17,95,63,158
42,18/04/2016,18,76,41,117
42,18/04/2016,19,69,38,107
42,18/04/2016,20,42,17,59
42,18/04/2016,21,22,13,35
42,18/04/2016,22,20,4,24
42,18/04/2016,23,9,3,12
42,19/04/2016,0,4,4,8
42,19/04/2016,1,2,0,2
42,19/04/2016,2,2,0,2
42,19/04/2016,3,0,1,1
42,19/04/2016,4,1,0,1
42,19/04/2016,5,0,3,3
42,19/04/2016,6,6,10,16
42,19/04/2016,7,37,57,94
42,19/04/2016,8,52,140,192
42,19/04/2016,9,34,95,129
42,19/04/2016,10,10,50,60
42,19/04/2016,11,20,24,44
42,19/04/2016,12,17,32,49
42,19/04/2016,13,27,32,59
42,19/04/2016,14,39,33,72
42,19/04/2016,15,40,45,85
42,19/04/2016,16,71,52,123
42,19/04/2016,17,124,87,211
42,19/04/2016,18,99,70,169
42,19/04/2016,19,54,29,83
42,19/04/2016,20,54,17,71
42,19/04/2016,21,26,20,46
42,19/04/2016,22,19,7,26
42,19/04/2016,23,11,10,21
42,20/04/2016,0,7,3,10
42,20/04/2016,1,6,1,7
42,20/04/2016,2,0,1,1
42,20/04/2016,3,0,0,0
42,20/04/2016,4,0,1,1
42,20/04/2016,5,0,1,1
42,20/04/2016,6,5,17,22
42,20/04/2016,7,33,56,89
42,20/04/2016,8,62,146,208
42,20/04/2016,9,30,80,110
42,20/04/2016,10,16,54,70
42,20/04/2016,11,12,23,35
42,20/04/2016,12,22,37,59
42,20/04/2016,13,24,42,66
42,20/04/2016,14,31,43,74
42,20/04/2016,15,46,51,97
42,20/04/2016,16,87,61,148
42,20/04/2016,17,116,94,210
42,20/04/2016,18,83,73,156
42,20/04/2016,19,95,37,132
42,20/04/2016,20,60,33,93
42,20/04/2016,21,41,14,55
42,20/04/2016,22,24,11,35
42,20/04/2016,23,9,11,20
42,21/04/2016,0,5,4,9
42,21/04/2016,1,3,2,5
42,21/04/2016,2,1,1,2
42,21/04/2016,3,0,0,0
42,21/04/2016,4,2,0,2
42,21/04/2016,5,0,4,4
42,21/04/2016,6,6,12,18
42,21/04/2016,7,32,53,85
42,21/04/2016,8,62,142,204
42,21/04/2016,9,23,90,113
42,21/04/2016,10,18,41,59
42,21/04/2016,11,32,29,61
42,21/04/2016,12,26,27,53
42,21/04/2016,13,54,34,88
42,21/04/2016,14,34,47,81
42,21/04/2016,15,46,37,83
42,21/04/2016,16,67,57,124
42,21/04/2016,17,113,104,217
42,21/04/2016,18,85,64,149
42,21/04/2016,19,64,42,106
42,21/04/2016,20,40,20,60
42,21/04/2016,21,21,14,35
42,21/04/2016,22,26,6,32
42,21/04/2016,23,14,9,23
42,22/04/2016,0,4,1,5
42,22/04/2016,1,4,2,6
42,22/04/2016,2,1,0,1
42,22/04/2016,3,0,0,0
42,22/04/2016,4,0,0,0
42,22/04/2016,5,1,3,4
42,22/04/2016,6,3,9,12
42,22/04/2016,7,23,51,74
42,22/04/2016,8,41,125,166
42,22/04/2016,9,25,79,104
42,22/04/2016,10,13,38,51
42,22/04/2016,11,20,22,42
42,22/04/2016,12,33,37,70
42,22/04/2016,13,27,26,53
42,22/04/2016,14,28,37,65
42,22/04/2016,15,39,35,74
42,22/04/2016,16,46,46,92
42,22/04/2016,17,101,58,159
42,22/04/2016,18,53,40,93
42,22/04/2016,19,40,30,70
42,22/04/2016,20,32,19,51
42,22/04/2016,21,23,12,35
42,22/04/2016,22,25,12,37
42,22/04/2016,23,11,6,17
42,23/04/2016,0,12,3,15
42,23/04/2016,1,4,3,7
42,23/04/2016,2,0,1,1
42,23/04/2016,3,2,0,2
42,23/04/2016,4,3,1,4
42,23/04/2016,5,1,2,3
42,23/04/2016,6,4,2,6
42,23/04/2016,7,4,17,21
42,23/04/2016,8,7,32,39
42,23/04/2016,9,17,30,47
42,23/04/2016,10,27,41,68
42,23/04/2016,11,50,255,305
42,23/04/2016,12,34,75,109
42,23/04/2016,13,63,31,94
42,23/04/2016,14,108,37,145
42,23/04/2016,15,43,26,69
42,23/04/2016,16,36,28,64
42,23/04/2016,17,36,15,51
42,23/04/2016,18,24,28,52
42,23/04/2016,19,14,25,39
42,23/04/2016,20,21,14,35
42,23/04/2016,21,19,5,24
42,23/04/2016,22,19,9,28
42,23/04/2016,23,19,3,22
42,24/04/2016,0,6,6,12
42,24/04/2016,1,5,2,7
42,24/04/2016,2,2,1,3
42,24/04/2016,3,7,2,9
42,24/04/2016,4,2,0,2
42,24/04/2016,5,2,1,3
42,24/04/2016,6,0,1,1
42,24/04/2016,7,8,8,16
42,24/04/2016,8,9,27,36
42,24/04/2016,9,15,22,37
42,24/04/2016,10,33,20,53
42,24/04/2016,11,41,39,80
42,24/04/2016,12,29,32,61
42,24/04/2016,13,25,47,72
42,24/04/2016,14,26,44,70
42,24/04/2016,15,36,38,74
42,24/04/2016,16,31,31,62
42,24/04/2016,17,31,32,63
42,24/04/2016,18,35,18,53
42,24/04/2016,19,24,22,46
42,24/04/2016,20,22,16,38
42,24/04/2016,21,14,12,26
42,24/04/2016,22,22,7,29
42,24/04/2016,23,5,1,6
42,25/04/2016,0,4,4,8
42,25/04/2016,1,6,0,6
42,25/04/2016,2,2,0,2
42,25/04/2016,3,1,1,2
42,25/04/2016,4,1,0,1
42,25/04/2016,5,1,4,5
42,25/04/2016,6,2,11,13
42,25/04/2016,7,25,59,84
42,25/04/2016,8,67,148,215
42,25/04/2016,9,25,79,104
42,25/04/2016,10,9,44,53
42,25/04/2016,11,22,21,43
42,25/04/2016,12,19,23,42
42,25/04/2016,13,24,32,56
42,25/04/2016,14,24,30,54
42,25/04/2016,15,25,32,57
42,25/04/2016,16,69,28,97
42,25/04/2016,17,111,78,189
42,25/04/2016,18,85,65,150
42,25/04/2016,19,40,23,63
42,25/04/2016,20,37,20,57
42,25/04/2016,21,22,11,33
42,25/04/2016,22,17,5,22
42,25/04/2016,23,6,4,10
42,26/04/2016,0,7,3,10
42,26/04/2016,1,1,0,1
42,26/04/2016,2,0,0,0
42,26/04/2016,3,1,0,1
42,26/04/2016,4,0,0,0
42,26/04/2016,5,0,3,3
42,26/04/2016,6,4,15,19
42,26/04/2016,7,27,45,72
42,26/04/2016,8,69,117,186
42,26/04/2016,9,16,84,100
42,26/04/2016,10,11,33,44
42,26/04/2016,11,7,26,33
42,26/04/2016,12,27,30,57
42,26/04/2016,13,17,23,40
42,26/04/2016,14,26,24,50
42,26/04/2016,15,36,34,70
42,26/04/2016,16,60,33,93
42,26/04/2016,17,90,66,156
42,26/04/2016,18,80,60,140
42,26/04/2016,19,38,20,58
42,26/04/2016,20,32,21,53
42,26/04/2016,21,26,15,41
42,26/04/2016,22,17,7,24
42,26/04/2016,23,12,3,15
42,27/04/2016,0,6,2,8
42,27/04/2016,1,5,0,5
42,27/04/2016,2,1,0,1
42,27/04/2016,3,2,1,3
42,27/04/2016,4,0,0,0
42,27/04/2016,5,1,5,6
42,27/04/2016,6,8,18,26
42,27/04/2016,7,20,59,79
42,27/04/2016,8,69,116,185
42,27/04/2016,9,25,83,108
42,27/04/2016,10,14,43,57
42,27/04/2016,11,16,30,46
42,27/04/2016,12,33,31,64
42,27/04/2016,13,27,26,53
42,27/04/2016,14,26,28,54
42,27/04/2016,15,34,24,58
42,27/04/2016,16,60,36,96
42,27/04/2016,17,111,74,185
42,27/04/2016,18,72,56,128
42,27/04/2016,19,46,28,74
42,27/04/2016,20,31,19,50
42,27/04/2016,21,24,6,30
42,27/04/2016,22,17,7,24
42,27/04/2016,23,12,6,18
42,28/04/2016,0,9,5,14
42,28/04/2016,1,1,0,1
42,28/04/2016,2,1,2,3
42,28/04/2016,3,3,0,3
42,28/04/2016,4,0,0,0
42,28/04/2016,5,1,2,3
42,28/04/2016,6,6,12,18
42,28/04/2016,7,29,43,72
42,28/04/2016,8,58,140,198
42,28/04/2016,9,26,58,84
42,28/04/2016,10,14,34,48
42,28/04/2016,11,16,17,33
42,28/04/2016,12,19,20,39
42,28/04/2016,13,18,26,44
42,28/04/2016,14,22,22,44
42,28/04/2016,15,28,16,44
42,28/04/2016,16,48,24,72
42,28/04/2016,17,77,64,141
42,28/04/2016,18,68,42,110
42,28/04/2016,19,41,30,71
42,28/04/2016,20,32,25,57
42,28/04/2016,21,21,13,34
42,28/04/2016,22,25,7,32
42,28/04/2016,23,7,4,11
42,29/04/2016,0,5,2,7
42,29/04/2016,1,3,0,3
42,29/04/2016,2,0,0,0
42,29/04/2016,3,2,0,2
42,29/04/2016,4,0,1,1
42,29/04/2016,5,2,2,4
42,29/04/2016,6,2,8,10
42,29/04/2016,7,10,30,40
42,29/04/2016,8,26,77,103
42,29/04/2016,9,16,46,62
42,29/04/2016,10,16,32,48
42,29/04/2016,11,6,19,25
42,29/04/2016,12,19,18,37
42,29/04/2016,13,21,15,36
42,29/04/2016,14,17,19,36
42,29/04/2016,15,22,8,30
42,29/04/2016,16,32,18,50
42,29/04/2016,17,63,35,98
42,29/04/2016,18,47,31,78
42,29/04/2016,19,21,21,42
42,29/04/2016,20,16,15,31
42,29/04/2016,21,10,12,22
42,29/04/2016,22,15,5,20
42,29/04/2016,23,16,4,20
42,30/04/2016,0,5,3,8
42,30/04/2016,1,7,4,11
42,30/04/2016,2,4,3,7
42,30/04/2016,3,4,0,4
42,30/04/2016,4,0,0,0
42,30/04/2016,5,1,2,3
42,30/04/2016,6,1,2,3
42,30/04/2016,7,2,8,10
42,30/04/2016,8,3,24,27
42,30/04/2016,9,11,31,42
42,30/04/2016,10,28,25,53
42,30/04/2016,11,25,32,57
42,30/04/2016,12,24,31,55
42,30/04/2016,13,26,22,48
42,30/04/2016,14,29,26,55
42,30/04/2016,15,25,31,56
42,30/04/2016,16,24,32,56
42,30/04/2016,17,43,28,71
42,30/04/2016,18,24,21,45
42,30/04/2016,19,34,19,53
42,30/04/2016,20,15,13,28
42,30/04/2016,21,17,15,32
42,30/04/2016,22,10,9,19
42,30/04/2016,23,2,8,10
42,01/05/2016,0,16,6,22
42,01/05/2016,1,6,5,11
42,01/05/2016,2,3,1,4
42,01/05/2016,3,2,0,2
42,01/05/2016,4,1,1,2
42,01/05/2016,5,1,1,2
42,01/05/2016,6,0,1,1
42,01/05/2016,7,1,4,5
42,01/05/2016,8,3,20,23
42,01/05/2016,9,11,23,34
42,01/05/2016,10,8,22,30
42,01/05/2016,11,21,14,35
42,01/05/2016,12,17,21,38
42,01/05/2016,13,23,29,52
42,01/05/2016,14,13,30,43
42,01/05/2016,15,23,22,45
42,01/05/2016,16,18,19,37
42,01/05/2016,17,37,26,63
42,01/05/2016,18,34,22,56
42,01/05/2016,19,21,17,38
42,01/05/2016,20,22,15,37
42,01/05/2016,21,10,8,18
42,01/05/2016,22,14,7,21
42,01/05/2016,23,8,3,11
42,02/05/2016,0,8,2,10
42,02/05/2016,1,1,0,1
42,02/05/2016,2,0,0,0
42,02/05/2016,3,2,0,2
42,02/05/2016,4,0,0,0
42,02/05/2016,5,1,4,5
42,02/05/2016,6,1,4,5
42,02/05/2016,7,6,29,35
42,02/05/2016,8,20,60,80
42,02/05/2016,9,12,46,58
42,02/05/2016,10,12,31,43
42,02/05/2016,11,16,26,42
42,02/05/2016,12,19,31,50
42,02/05/2016,13,19,27,46
42,02/05/2016,14,22,26,48
42,02/05/2016,15,31,17,48
42,02/05/2016,16,30,24,54
42,02/05/2016,17,70,41,111
42,02/05/2016,18,52,33,85
42,02/05/2016,19,46,22,68
42,02/05/2016,20,32,18,50
42,02/05/2016,21,22,11,33
42,02/05/2016,22,11,6,17
42,02/05/2016,23,11,3,14
42,03/05/2016,0,4,4,8
42,03/05/2016,1,5,0,5
42,03/05/2016,2,3,0,3
42,03/05/2016,3,0,0,0
42,03/05/2016,4,0,0,0
42,03/05/2016,5,0,2,2
42,03/05/2016,6,3,14,17
42,03/05/2016,7,33,64,97
42,03/05/2016,8,55,134,189
42,03/05/2016,9,25,91,116
42,03/05/2016,10,19,42,61
42,03/05/2016,11,13,34,47
42,03/05/2016,12,19,24,43
42,03/05/2016,13,26,33,59
42,03/05/2016,14,30,27,57
42,03/05/2016,15,28,32,60
42,03/05/2016,16,61,34,95
42,03/05/2016,17,115,83,198
42,03/05/2016,18,86,53,139
42,03/05/2016,19,50,37,87
42,03/05/2016,20,33,17,50
42,03/05/2016,21,35,14,49
42,03/05/2016,22,17,5,22
42,03/05/2016,23,8,2,10
42,04/05/2016,0,11,10,21
42,04/05/2016,1,6,0,6
42,04/05/2016,2,1,0,1
42,04/05/2016,3,2,0,2
42,04/05/2016,4,0,0,0
42,04/05/2016,5,0,4,4
42,04/05/2016,6,6,15,21
42,04/05/2016,7,25,41,66
42,04/05/2016,8,57,142,199
42,04/05/2016,9,31,93,124
42,04/05/2016,10,14,34,48
42,04/05/2016,11,15,26,41
42,04/05/2016,12,23,28,51
42,04/05/2016,13,25,27,52
42,04/05/2016,14,25,24,49
42,04/05/2016,15,44,21,65
42,04/05/2016,16,51,41,92
42,04/05/2016,17,116,84,200
42,04/05/2016,18,79,68,147
42,04/05/2016,19,65,32,97
42,04/05/2016,20,47,20,67
42,04/05/2016,21,32,14,46
42,04/05/2016,22,19,13,32
42,04/05/2016,23,9,9,18
42,05/05/2016,0,5,6,11
42,05/05/2016,1,6,0,6
42,05/05/2016,2,1,1,2
42,05/05/2016,3,1,0,1
42,05/05/2016,4,0,0,0
42,05/05/2016,5,1,2,3
42,05/05/2016,6,4,14,18
42,05/05/2016,7,30,47,77
42,05/05/2016,8,49,121,170
42,05/05/2016,9,26,73,99
42,05/05/2016,10,16,46,62
42,05/05/2016,11,24,27,51
42,05/05/2016,12,24,27,51
42,05/05/2016,13,26,48,74
42,05/05/2016,14,33,29,62
42,05/05/2016,15,38,25,63
42,05/05/2016,16,67,45,112
42,05/05/2016,17,116,76,192
42,05/05/2016,18,68,54,122
42,05/05/2016,19,54,37,91
42,05/05/2016,20,41,29,70
42,05/05/2016,21,33,16,49
42,05/05/2016,22,14,7,21
42,05/05/2016,23,16,8,24
42,06/05/2016,0,6,6,12
42,06/05/2016,1,0,0,0
42,06/05/2016,2,3,0,3
42,06/05/2016,3,0,0,0
42,06/05/2016,4,0,1,1
42,06/05/2016,5,2,8,10
42,06/05/2016,6,1,8,9
42,06/05/2016,7,20,42,62
42,06/05/2016,8,54,117,171
42,06/05/2016,9,21,99,120
42,06/05/2016,10,14,47,61
42,06/05/2016,11,14,33,47
42,06/05/2016,12,33,30,63
42,06/05/2016,13,25,40,65
42,06/05/2016,14,31,28,59
42,06/05/2016,15,33,35,68
42,06/05/2016,16,59,62,121
42,06/05/2016,17,97,51,148
42,06/05/2016,18,64,44,108
42,06/05/2016,19,50,29,79
42,06/05/2016,20,30,27,57
42,06/05/2016,21,23,11,34
42,06/05/2016,22,17,6,23
42,06/05/2016,23,10,6,16
42,07/05/2016,0,1,6,7
42,07/05/2016,1,3,3,6
42,07/05/2016,2,2,1,3
42,07/05/2016,3,2,1,3
42,07/05/2016,4,0,3,3
42,07/05/2016,5,1,2,3
42,07/05/2016,6,2,2,4
42,07/05/2016,7,3,4,7
42,07/05/2016,8,9,14,23
42,07/05/2016,9,13,36,49
42,07/05/2016,10,19,32,51
42,07/05/2016,11,19,33,52
42,07/05/2016,12,25,40,65
42,07/05/2016,13,27,20,47
42,07/05/2016,14,19,35,54
42,07/05/2016,15,29,33,62
42,07/05/2016,16,43,20,63
42,07/05/2016,17,24,21,45
42,07/05/2016,18,34,24,58
42,07/05/2016,19,25,21,46
42,07/05/2016,20,24,18,42
42,07/05/2016,21,11,9,20
42,07/05/2016,22,13,5,18
42,07/05/2016,23,13,6,19
42,08/05/2016,0,1,7,8
42,08/05/2016,1,1,1,2
42,08/05/2016,2,0,0,0
42,08/05/2016,3,2,0,2
42,08/05/2016,4,0,3,3
42,08/05/2016,5,2,2,4
42,08/05/2016,6,1,1,2
42,08/05/2016,7,2,4,6
42,08/05/2016,8,7,16,23
42,08/05/2016,9,10,27,37
42,08/05/2016,10,15,30,45
42,08/05/2016,11,27,25,52
42,08/05/2016,12,14,29,43
42,08/05/2016,13,14,37,51
42,08/05/2016,14,31,35,66
42,08/05/2016,15,37,40,77
42,08/05/2016,16,45,41,86
42,08/05/2016,17,42,27,69
42,08/05/2016,18,43,31,74
42,08/05/2016,19,45,23,68
42,08/05/2016,20,23,17,40
42,08/05/2016,21,16,7,23
42,08/05/2016,22,9,4,13
42,08/05/2016,23,7,5,12
42,09/05/2016,0,4,1,5
42,09/05/2016,1,2,0,2
42,09/05/2016,2,5,0,5
42,09/05/2016,3,0,1,1
42,09/05/2016,4,1,2,3
42,09/05/2016,5,0,4,4
42,09/05/2016,6,6,10,16
42,09/05/2016,7,29,44,73
42,09/05/2016,8,66,139,205
42,09/05/2016,9,27,91,118
42,09/05/2016,10,13,49,62
42,09/05/2016,11,18,34,52
42,09/05/2016,12,17,35,52
42,09/05/2016,13,42,42,84
42,09/05/2016,14,36,25,61
42,09/05/2016,15,42,36,78
42,09/05/2016,16,73,53,126
42,09/05/2016,17,146,85,231
42,09/05/2016,18,94,69,163
42,09/05/2016,19,76,43,119
42,09/05/2016,20,49,24,73
42,09/05/2016,21,35,20,55
42,09/05/2016,22,12,11,23
42,09/05/2016,23,21,6,27
42,10/05/2016,0,1,3,4
42,10/05/2016,1,2,1,3
42,10/05/2016,2,2,0,2
42,10/05/2016,3,1,0,1
42,10/05/2016,4,0,1,1
42,10/05/2016,5,0,2,2
42,10/05/2016,6,5,14,19
42,10/05/2016,7,38,48,86
42,10/05/2016,8,77,144,221
42,10/05/2016,9,32,116,148
42,10/05/2016,10,19,35,54
42,10/05/2016,11,20,39,59
42,10/05/2016,12,23,39,62
42,10/05/2016,13,42,31,73
42,10/05/2016,14,31,34,65
42,10/05/2016,15,44,43,87
42,10/05/2016,16,78,59,137
42,10/05/2016,17,141,97,238
42,10/05/2016,18,98,83,181
42,10/05/2016,19,62,38,100
42,10/05/2016,20,59,28,87
42,10/05/2016,21,36,19,55
42,10/05/2016,22,18,8,26
42,10/05/2016,23,12,7,19
42,11/05/2016,0,9,2,11
42,11/05/2016,1,1,1,2
42,11/05/2016,2,4,1,5
42,11/05/2016,3,0,0,0
42,11/05/2016,4,0,0,0
42,11/05/2016,5,1,3,4
42,11/05/2016,6,7,16,23
42,11/05/2016,7,25,50,75
42,11/05/2016,8,64,125,189
42,11/05/2016,9,23,96,119
42,11/05/2016,10,19,45,64
42,11/05/2016,11,26,30,56
42,11/05/2016,12,22,30,52
42,11/05/2016,13,36,36,72
42,11/05/2016,14,47,33,80
42,11/05/2016,15,42,30,72
42,11/05/2016,16,60,41,101
42,11/05/2016,17,120,96,216
42,11/05/2016,18,88,68,156
42,11/05/2016,19,64,45,109
42,11/05/2016,20,43,27,70
42,11/05/2016,21,43,17,60
42,11/05/2016,22,23,12,35
42,11/05/2016,23,13,6,19
42,12/05/2016,0,7,7,14
42,12/05/2016,1,4,0,4
42,12/05/2016,2,3,6,9
42,12/05/2016,3,0,2,2
42,12/05/2016,4,0,0,0
42,12/05/2016,5,0,1,1
42,12/05/2016,6,4,7,11
42,12/05/2016,7,35,60,95
42,12/05/2016,8,64,130,194
42,12/05/2016,9,24,77,101
42,12/05/2016,10,26,44,70
42,12/05/2016,11,19,29,48
42,12/05/2016,12,22,38,60
42,12/05/2016,13,25,41,66
42,12/05/2016,14,27,46,73
42,12/05/2016,15,38,30,68
42,12/05/2016,16,79,54,133
42,12/05/2016,17,108,98,206
42,12/05/2016,18,94,75,169
42,12/05/2016,19,65,50,115
42,12/05/2016,20,54,19,73
42,12/05/2016,21,35,19,54
42,12/05/2016,22,20,6,26
42,12/05/2016,23,10,7,17
42,13/05/2016,0,6,3,9
42,13/05/2016,1,6,2,8
42,13/05/2016,2,3,1,4
42,13/05/2016,3,0,0,0
42,13/05/2016,4,0,0,0
42,13/05/2016,5,0,4,4
42,13/05/2016,6,3,18,21
42,13/05/2016,7,21,39,60
42,13/05/2016,8,57,104,161
42,13/05/2016,9,27,85,112
42,13/05/2016,10,18,42,60
42,13/05/2016,11,14,24,38
42,13/05/2016,12,44,28,72
42,13/05/2016,13,32,25,57
42,13/05/2016,14,37,33,70
42,13/05/2016,15,47,22,69
42,13/05/2016,16,53,43,96
42,13/05/2016,17,91,53,144
42,13/05/2016,18,48,46,94
42,13/05/2016,19,33,41,74
42,13/05/2016,20,34,20,54
42,13/05/2016,21,31,27,58
42,13/05/2016,22,22,9,31
42,13/05/2016,23,13,7,20
42,14/05/2016,0,8,5,13
42,14/05/2016,1,5,3,8
42,14/05/2016,2,3,2,5
42,14/05/2016,3,3,0,3
42,14/05/2016,4,1,0,1
42,14/05/2016,5,2,3,5
42,14/05/2016,6,1,2,3
42,14/05/2016,7,6,7,13
42,14/05/2016,8,10,22,32
42,14/05/2016,9,20,35,55
42,14/05/2016,10,28,55,83
42,14/05/2016,11,29,43,72
42,14/05/2016,12,40,40,80
42,14/05/2016,13,30,29,59
42,14/05/2016,14,22,36,58
42,14/05/2016,15,36,45,81
42,14/05/2016,16,31,22,53
42,14/05/2016,17,31,30,61
42,14/05/2016,18,31,22,53
42,14/05/2016,19,34,25,59
42,14/05/2016,20,12,18,30
42,14/05/2016,21,10,10,20
42,14/05/2016,22,8,4,12
42,14/05/2016,23,15,5,20
42,15/05/2016,0,6,6,12
42,15/05/2016,1,6,3,9
42,15/05/2016,2,6,2,8
42,15/05/2016,3,1,1,2
42,15/05/2016,4,2,0,2
42,15/05/2016,5,1,1,2
42,15/05/2016,6,3,4,7
42,15/05/2016,7,5,5,10
42,15/05/2016,8,8,21,29
42,15/05/2016,9,14,36,50
42,15/05/2016,10,19,25,44
42,15/05/2016,11,20,34,54
42,15/05/2016,12,23,26,49
42,15/05/2016,13,30,46,76
42,15/05/2016,14,31,41,72
42,15/05/2016,15,29,24,53
42,15/05/2016,16,26,40,66
42,15/05/2016,17,41,34,75
42,15/05/2016,18,33,35,68
42,15/05/2016,19,36,19,55
42,15/05/2016,20,24,14,38
42,15/05/2016,21,18,14,32
42,15/05/2016,22,11,7,18
42,15/05/2016,23,7,3,10
42,16/05/2016,0,6,5,11
42,16/05/2016,1,4,0,4
42,16/05/2016,2,1,0,1
42,16/05/2016,3,2,0,2
42,16/05/2016,4,1,0,1
42,16/05/2016,5,0,2,2
42,16/05/2016,6,11,11,22
42,16/05/2016,7,32,44,76
42,16/05/2016,8,61,138,199
42,16/05/2016,9,24,109,133
42,16/05/2016,10,19,37,56
42,16/05/2016,11,14,28,42
42,16/05/2016,12,21,34,55
42,16/05/2016,13,19,25,44
42,16/05/2016,14,29,34,63
42,16/05/2016,15,31,22,53
42,16/05/2016,16,57,56,113
42,16/05/2016,17,117,88,205
42,16/05/2016,18,90,68,158
42,16/05/2016,19,70,38,108
42,16/05/2016,20,34,23,57
42,16/05/2016,21,37,14,51
42,16/05/2016,22,22,7,29
42,16/05/2016,23,13,5,18
42,17/05/2016,0,1,2,3
42,17/05/2016,1,7,2,9
42,17/05/2016,2,2,0,2
42,17/05/2016,3,0,0,0
42,17/05/2016,4,0,3,3
42,17/05/2016,5,1,1,2
42,17/05/2016,6,1,16,17
42,17/05/2016,7,45,54,99
42,17/05/2016,8,53,145,198
42,17/05/2016,9,35,94,129
42,17/05/2016,10,14,48,62
42,17/05/2016,11,17,29,46
42,17/05/2016,12,20,28,48
42,17/05/2016,13,23,35,58
42,17/05/2016,14,39,31,70
42,17/05/2016,15,44,26,70
42,17/05/2016,16,55,36,91
42,17/05/2016,17,122,75,197
42,17/05/2016,18,72,52,124
42,17/05/2016,19,35,33,68
42,17/05/2016,20,46,20,66
42,17/05/2016,21,30,16,46
42,17/05/2016,22,20,9,29
42,17/05/2016,23,7,7,14
42,18/05/2016,0,5,3,8
42,18/05/2016,1,5,0,5
42,18/05/2016,2,4,0,4
42,18/05/2016,3,0,1,1
42,18/05/2016,4,0,1,1
42,18/05/2016,5,1,2,3
42,18/05/2016,6,7,9,16
42,18/05/2016,7,25,44,69
42,18/05/2016,8,53,129,182
42,18/05/2016,9,30,96,126
42,18/05/2016,10,11,26,37
42,18/05/2016,11,16,16,32
42,18/05/2016,12,23,19,42
42,18/05/2016,13,27,30,57
42,18/05/2016,14,25,32,57
42,18/05/2016,15,27,37,64
42,18/05/2016,16,53,46,99
42,18/05/2016,17,111,70,181
42,18/05/2016,18,85,60,145
42,18/05/2016,19,56,28,84
42,18/05/2016,20,39,18,57
42,18/05/2016,21,16,11,27
42,18/05/2016,22,18,15,33
42,18/05/2016,23,11,6,17
42,19/05/2016,0,4,5,9
42,19/05/2016,1,4,0,4
42,19/05/2016,2,0,0,0
42,19/05/2016,3,0,0,0
42,19/05/2016,4,1,0,1
42,19/05/2016,5,1,2,3
42,19/05/2016,6,7,14,21
42,19/05/2016,7,26,37,63
42,19/05/2016,8,54,113,167
42,19/05/2016,9,22,73,95
42,19/05/2016,10,16,33,49
42,19/05/2016,11,17,28,45
42,19/05/2016,12,25,30,55
42,19/05/2016,13,26,30,56
42,19/05/2016,14,27,18,45
42,19/05/2016,15,36,21,57
42,19/05/2016,16,51,43,94
42,19/05/2016,17,96,75,171
42,19/05/2016,18,74,41,115
42,19/05/2016,19,38,35,73
42,19/05/2016,20,40,17,57
42,19/05/2016,21,31,15,46
42,19/05/2016,22,11,10,21
42,19/05/2016,23,9,5,14
42,20/05/2016,0,6,3,9
42,20/05/2016,1,2,0,2
42,20/05/2016,2,0,0,0
42,20/05/2016,3,2,0,2
42,20/05/2016,4,1,0,1
42,20/05/2016,5,1,2,3
42,20/05/2016,6,11,9,20
42,20/05/2016,7,22,47,69
42,20/05/2016,8,44,111,155
42,20/05/2016,9,25,60,85
42,20/05/2016,10,11,36,47
42,20/05/2016,11,24,28,52
42,20/05/2016,12,35,28,63
42,20/05/2016,13,34,40,74
42,20/05/2016,14,33,30,63
42,20/05/2016,15,31,57,88
42,20/05/2016,16,63,58,121
42,20/05/2016,17,88,46,134
42,20/05/2016,18,66,40,106
42,20/05/2016,19,33,34,67
42,20/05/2016,20,14,16,30
42,20/05/2016,21,26,9,35
42,20/05/2016,22,18,10,28
42,20/05/2016,23,7,8,15
42,21/05/2016,0,8,9,17
42,21/05/2016,1,7,2,9
42,21/05/2016,2,4,0,4
42,21/05/2016,3,2,2,4
42,21/05/2016,4,5,2,7
42,21/05/2016,5,1,2,3
42,21/05/2016,6,0,4,4
42,21/05/2016,7,4,5,9
42,21/05/2016,8,7,12,19
42,21/05/2016,9,13,25,38
42,21/05/2016,10,18,39,57
42,21/05/2016,11,27,36,63
42,21/05/2016,12,22,33,55
42,21/05/2016,13,29,24,53
42,21/05/2016,14,12,20,32
42,21/05/2016,15,23,27,50
42,21/05/2016,16,30,14,44
42,21/05/2016,17,24,20,44
42,21/05/2016,18,18,11,29
42,21/05/2016,19,18,12,30
42,21/05/2016,20,11,9,20
42,21/05/2016,21,11,8,19
42,21/05/2016,22,6,8,14
42,21/05/2016,23,5,6,11
42,22/05/2016,0,3,15,18
42,22/05/2016,1,2,0,2
42,22/05/2016,2,3,2,5
42,22/05/2016,3,1,0,1
42,22/05/2016,4,0,0,0
42,22/05/2016,5,0,1,1
42,22/05/2016,6,1,1,2
42,22/05/2016,7,7,2,9
42,22/05/2016,8,13,15,28
42,22/05/2016,9,13,21,34
42,22/05/2016,10,30,37,67
42,22/05/2016,11,33,29,62
42,22/05/2016,12,19,16,35
42,22/05/2016,13,26,25,51
42,22/05/2016,14,25,36,61
42,22/05/2016,15,19,35,54
42,22/05/2016,16,32,20,52
42,22/05/2016,17,38,26,64
42,22/05/2016,18,25,9,34
42,22/05/2016,19,23,14,37
42,22/05/2016,20,20,15,35
42,22/05/2016,21,23,13,36
42,22/05/2016,22,6,7,13
42,22/05/2016,23,5,1,6
42,23/05/2016,0,3,1,4
42,23/05/2016,1,3,0,3
42,23/05/2016,2,1,1,2
42,23/05/2016,3,1,1,2
42,23/05/2016,4,0,0,0
42,23/05/2016,5,0,1,1
42,23/05/2016,6,8,8,16
42,23/05/2016,7,19,47,66
42,23/05/2016,8,51,98,149
42,23/05/2016,9,27,74,101
42,23/05/2016,10,13,45,58
42,23/05/2016,11,12,35,47
42,23/05/2016,12,30,23,53
42,23/05/2016,13,36,36,72
42,23/05/2016,14,34,29,63
42,23/05/2016,15,41,45,86
42,23/05/2016,16,53,49,102
42,23/05/2016,17,106,73,179
42,23/05/2016,18,85,48,133
42,23/05/2016,19,47,47,94
42,23/05/2016,20,52,27,79
42,23/05/2016,21,41,19,60
42,23/05/2016,22,21,7,28
42,23/05/2016,23,8,7,15
42,24/05/2016,0,8,4,12
42,24/05/2016,1,7,0,7
42,24/05/2016,2,3,1,4
42,24/05/2016,3,1,1,2
42,24/05/2016,4,0,0,0
42,24/05/2016,5,0,1,1
42,24/05/2016,6,11,11,22
42,24/05/2016,7,32,64,96
42,24/05/2016,8,62,124,186
42,24/05/2016,9,28,101,129
42,24/05/2016,10,15,43,58
42,24/05/2016,11,17,40,57
42,24/05/2016,12,22,25,47
42,24/05/2016,13,28,32,60
42,24/05/2016,14,22,34,56
42,24/05/2016,15,41,38,79
42,24/05/2016,16,63,34,97
42,24/05/2016,17,129,86,215
42,24/05/2016,18,73,75,148
42,24/05/2016,19,46,39,85
42,24/05/2016,20,48,22,70
42,24/05/2016,21,33,8,41
42,24/05/2016,22,22,10,32
42,24/05/2016,23,7,6,13
42,25/05/2016,0,2,5,7
42,25/05/2016,1,1,1,2
42,25/05/2016,2,1,0,1
42,25/05/2016,3,2,0,2
42,25/05/2016,4,0,0,0
42,25/05/2016,5,1,1,2
42,25/05/2016,6,8,13,21
42,25/05/2016,7,23,50,73
42,25/05/2016,8,68,114,182
42,25/05/2016,9,22,89,111
42,25/05/2016,10,16,35,51
42,25/05/2016,11,13,22,35
42,25/05/2016,12,21,16,37
42,25/05/2016,13,20,26,46
42,25/05/2016,14,25,30,55
42,25/05/2016,15,37,33,70
42,25/05/2016,16,57,42,99
42,25/05/2016,17,112,79,191
42,25/05/2016,18,75,59,134
42,25/05/2016,19,43,37,80
42,25/05/2016,20,35,24,59
42,25/05/2016,21,22,15,37
42,25/05/2016,22,19,5,24
42,25/05/2016,23,9,4,13
42,26/05/2016,0,4,1,5
42,26/05/2016,1,2,1,3
42,26/05/2016,2,3,0,3
42,26/05/2016,3,2,1,3
42,26/05/2016,4,0,0,0
42,26/05/2016,5,0,5,5
42,26/05/2016,6,9,14,23
42,26/05/2016,7,23,47,70
42,26/05/2016,8,44,120,164
42,26/05/2016,9,29,90,119
42,26/05/2016,10,8,29,37
42,26/05/2016,11,23,26,49
42,26/05/2016,12,17,21,38
42,26/05/2016,13,20,20,40
42,26/05/2016,14,22,18,40
42,26/05/2016,15,27,23,50
42,26/05/2016,16,54,28,82
42,26/05/2016,17,80,48,128
42,26/05/2016,18,46,37,83
42,26/05/2016,19,36,22,58
42,26/05/2016,20,25,10,35
42,26/05/2016,21,18,12,30
42,26/05/2016,22,13,6,19
42,26/05/2016,23,5,4,9
42,27/05/2016,0,2,2,4
42,27/05/2016,1,2,1,3
42,27/05/2016,2,0,0,0
42,27/05/2016,3,0,0,0
42,27/05/2016,4,0,0,0
42,27/05/2016,5,0,3,3
42,27/05/2016,6,5,10,15
42,27/05/2016,7,16,32,48
42,27/05/2016,8,39,65,104
42,27/05/2016,9,19,61,80
42,27/05/2016,10,18,31,49
42,27/05/2016,11,16,20,36
42,27/05/2016,12,26,24,50
42,27/05/2016,13,21,26,47
42,27/05/2016,14,28,29,57
42,27/05/2016,15,18,22,40
42,27/05/2016,16,38,27,65
42,27/05/2016,17,80,46,126
42,27/05/2016,18,43,24,67
42,27/05/2016,19,20,20,40
42,27/05/2016,20,22,15,37
42,27/05/2016,21,14,9,23
42,27/05/2016,22,9,4,13
42,27/05/2016,23,6,2,8
42,28/05/2016,0,7,6,13
42,28/05/2016,1,2,0,2
42,28/05/2016,2,2,0,2
42,28/05/2016,3,3,0,3
42,28/05/2016,4,3,0,3
42,28/05/2016,5,0,1,1
42,28/05/2016,6,2,3,5
42,28/05/2016,7,6,4,10
42,28/05/2016,8,5,24,29
42,28/05/2016,9,11,21,32
42,28/05/2016,10,18,46,64
42,28/05/2016,11,17,18,35
42,28/05/2016,12,25,25,50
42,28/05/2016,13,26,26,52
42,28/05/2016,14,17,25,42
42,28/05/2016,15,38,20,58
42,28/05/2016,16,38,32,70
42,28/05/2016,17,26,20,46
42,28/05/2016,18,29,18,47
42,28/05/2016,19,22,22,44
42,28/05/2016,20,13,13,26
42,28/05/2016,21,13,16,29
42,28/05/2016,22,10,6,16
42,28/05/2016,23,10,9,19
42,05/06/2016,0,7,2,9
42,05/06/2016,1,3,2,5
42,05/06/2016,2,0,0,0
42,05/06/2016,3,0,1,1
42,05/06/2016,4,1,1,2
42,05/06/2016,5,1,2,3
42,05/06/2016,6,0,3,3
42,05/06/2016,7,3,5,8
42,05/06/2016,8,11,13,24
42,05/06/2016,9,12,17,29
42,05/06/2016,10,18,30,48
42,05/06/2016,11,20,42,62
42,05/06/2016,12,41,55,96
42,05/06/2016,13,28,69,97
42,05/06/2016,14,34,62,96
42,05/06/2016,15,32,52,84
42,05/06/2016,16,42,43,85
42,05/06/2016,17,36,40,76
42,05/06/2016,18,43,36,79
42,05/06/2016,19,36,18,54
42,05/06/2016,20,36,17,53
42,05/06/2016,21,27,12,39
42,05/06/2016,22,6,11,17
42,05/06/2016,23,8,4,12
42,06/06/2016,0,8,1,9
42,06/06/2016,1,4,0,4
42,06/06/2016,2,1,0,1
42,06/06/2016,3,1,0,1
42,06/06/2016,4,0,0,0
42,06/06/2016,5,0,0,0
42,06/06/2016,6,9,11,20
42,06/06/2016,7,26,44,70
42,06/06/2016,8,60,120,180
42,06/06/2016,9,28,96,124
42,06/06/2016,10,22,47,69
42,06/06/2016,11,20,30,50
42,06/06/2016,12,24,31,55
42,06/06/2016,13,24,24,48
42,06/06/2016,14,31,32,63
42,06/06/2016,15,38,33,71
42,06/06/2016,16,57,38,95
42,06/06/2016,17,109,90,199
42,06/06/2016,18,73,57,130
42,06/06/2016,19,43,47,90
42,06/06/2016,20,43,16,59
42,06/06/2016,21,42,8,50
42,06/06/2016,22,15,12,27
42,06/06/2016,23,11,9,20
42,07/06/2016,0,9,5,14
42,07/06/2016,1,2,2,4
42,07/06/2016,2,2,0,2
42,07/06/2016,3,0,0,0
42,07/06/2016,4,0,1,1
42,07/06/2016,5,1,4,5
42,07/06/2016,6,12,11,23
42,07/06/2016,7,27,44,71
42,07/06/2016,8,59,118,177
42,07/06/2016,9,35,105,140
42,07/06/2016,10,13,31,44
42,07/06/2016,11,22,28,50
42,07/06/2016,12,28,25,53
42,07/06/2016,13,24,43,67
42,07/06/2016,14,33,31,64
42,07/06/2016,15,32,25,57
42,07/06/2016,16,54,33,87
42,07/06/2016,17,98,101,199
42,07/06/2016,18,81,67,148
42,07/06/2016,19,36,34,70
42,07/06/2016,20,44,34,78
42,07/06/2016,21,30,15,45
42,07/06/2016,22,25,8,33
42,07/06/2016,23,5,3,8
42,08/06/2016,0,4,2,6
42,08/06/2016,1,4,1,5
42,08/06/2016,2,1,0,1
42,08/06/2016,3,0,0,0
42,08/06/2016,4,1,0,1
42,08/06/2016,5,1,2,3
42,08/06/2016,6,15,15,30
42,08/06/2016,7,22,45,67
42,08/06/2016,8,56,102,158
42,08/06/2016,9,29,87,116
42,08/06/2016,10,22,39,61
42,08/06/2016,11,26,29,55
42,08/06/2016,12,21,40,61
42,08/06/2016,13,29,34,63
42,08/06/2016,14,37,38,75
42,08/06/2016,15,39,40,79
42,08/06/2016,16,53,43,96
42,08/06/2016,17,98,91,189
42,08/06/2016,18,77,54,131
42,08/06/2016,19,45,45,90
42,08/06/2016,20,54,26,80
42,08/06/2016,21,31,20,51
42,08/06/2016,22,22,14,36
42,08/06/2016,23,8,9,17
42,09/06/2016,0,9,3,12
42,09/06/2016,1,2,0,2
42,09/06/2016,2,0,0,0
42,09/06/2016,3,1,1,2
42,09/06/2016,4,0,1,1
42,09/06/2016,5,2,2,4
42,09/06/2016,6,10,14,24
42,09/06/2016,7,27,55,82
42,09/06/2016,8,61,127,188
42,09/06/2016,9,26,82,108
42,09/06/2016,10,21,46,67
42,09/06/2016,11,20,29,49
42,09/06/2016,12,35,25,60
42,09/06/2016,13,26,28,54
42,09/06/2016,14,40,37,77
42,09/06/2016,15,45,31,76
42,09/06/2016,16,52,58,110
42,09/06/2016,17,121,76,197
42,09/06/2016,18,75,55,130
42,09/06/2016,19,51,43,94
42,09/06/2016,20,50,27,77
42,09/06/2016,21,31,22,53
42,09/06/2016,22,21,7,28
42,09/06/2016,23,14,6,20
42,10/06/2016,0,9,5,14
42,10/06/2016,1,2,1,3
42,10/06/2016,2,2,0,2
42,10/06/2016,3,1,1,2
42,10/06/2016,4,1,0,1
42,10/06/2016,5,1,3,4
42,10/06/2016,6,5,4,9
42,10/06/2016,7,14,37,51
42,10/06/2016,8,37,66,103
42,10/06/2016,9,21,58,79
42,10/06/2016,10,13,23,36
42,10/06/2016,11,12,20,32
42,10/06/2016,12,23,27,50
42,10/06/2016,13,25,24,49
42,10/06/2016,14,22,18,40
42,10/06/2016,15,24,27,51
42,10/06/2016,16,39,27,66
42,10/06/2016,17,71,44,115
42,10/06/2016,18,41,40,81
42,10/06/2016,19,26,18,44
42,10/06/2016,20,16,17,33
42,10/06/2016,21,17,13,30
42,10/06/2016,22,14,5,19
42,10/06/2016,23,5,8,13
42,11/06/2016,0,9,3,12
42,11/06/2016,1,4,6,10
42,11/06/2016,2,1,1,2
42,11/06/2016,3,0,1,1
42,11/06/2016,4,1,1,2
42,11/06/2016,5,0,0,0
42,11/06/2016,6,1,3,4
42,11/06/2016,7,3,4,7
42,11/06/2016,8,10,17,27
42,11/06/2016,9,8,20,28
42,11/06/2016,10,13,43,56
42,11/06/2016,11,29,24,53
42,11/06/2016,12,25,34,59
42,11/06/2016,13,16,31,47
42,11/06/2016,14,39,25,64
42,11/06/2016,15,19,29,48
42,11/06/2016,16,28,16,44
42,11/06/2016,17,23,26,49
42,11/06/2016,18,20,17,37
42,11/06/2016,19,20,13,33
42,11/06/2016,20,14,15,29
42,11/06/2016,21,12,13,25
42,11/06/2016,22,16,7,23
42,11/06/2016,23,13,4,17
42,12/06/2016,0,8,2,10
42,12/06/2016,1,4,1,5
42,12/06/2016,2,1,0,1
42,12/06/2016,3,3,1,4
42,12/06/2016,4,0,1,1
42,12/06/2016,5,1,1,2
42,12/06/2016,6,1,1,2
42,12/06/2016,7,2,6,8
42,12/06/2016,8,4,11,15
42,12/06/2016,9,10,10,20
42,12/06/2016,10,9,17,26
42,12/06/2016,11,5,12,17
42,12/06/2016,12,8,8,16
42,12/06/2016,13,14,12,26
42,12/06/2016,14,12,18,30
42,12/06/2016,15,10,35,45
42,12/06/2016,16,20,13,33
42,12/06/2016,17,16,16,32
42,12/06/2016,18,22,17,39
42,12/06/2016,19,17,17,34
42,12/06/2016,20,13,10,23
42,12/06/2016,21,9,9,18
42,12/06/2016,22,14,11,25
42,12/06/2016,23,6,3,9
42,13/06/2016,0,6,1,7
42,13/06/2016,1,2,2,4
42,13/06/2016,2,0,0,0
42,13/06/2016,3,0,1,1
42,13/06/2016,4,0,1,1
42,13/06/2016,5,0,0,0
42,13/06/2016,6,11,10,21
42,13/06/2016,7,17,42,59
42,13/06/2016,8,42,99,141
42,13/06/2016,9,23,74,97
42,13/06/2016,10,10,34,44
42,13/06/2016,11,10,24,34
42,13/06/2016,12,9,17,26
42,13/06/2016,13,19,26,45
42,13/06/2016,14,21,30,51
42,13/06/2016,15,33,16,49
42,13/06/2016,16,44,40,84
42,13/06/2016,17,95,72,167
42,13/06/2016,18,54,50,104
42,13/06/2016,19,38,27,65
42,13/06/2016,20,39,20,59
42,13/06/2016,21,36,17,53
42,13/06/2016,22,13,16,29
42,13/06/2016,23,4,5,9
42,14/06/2016,0,7,3,10
42,14/06/2016,1,2,1,3
42,14/06/2016,2,1,0,1
42,14/06/2016,3,0,2,2
42,14/06/2016,4,0,1,1
42,14/06/2016,5,1,4,5
42,14/06/2016,6,10,15,25
42,14/06/2016,7,33,50,83
42,14/06/2016,8,61,115,176
42,14/06/2016,9,36,55,91
42,14/06/2016,10,12,31,43
42,14/06/2016,11,18,21,39
42,14/06/2016,12,23,19,42
42,14/06/2016,13,21,20,41
42,14/06/2016,14,24,10,34
42,14/06/2016,15,26,20,46
42,14/06/2016,16,43,29,72
42,14/06/2016,17,88,86,174
42,14/06/2016,18,61,44,105
42,14/06/2016,19,32,22,54
42,14/06/2016,20,28,14,42
42,14/06/2016,21,17,14,31
42,14/06/2016,22,9,6,15
42,14/06/2016,23,5,6,11
42,15/06/2016,0,4,1,5
42,15/06/2016,1,4,0,4
42,15/06/2016,2,1,0,1
42,15/06/2016,3,0,0,0
42,15/06/2016,4,1,0,1
42,15/06/2016,5,2,0,2
42,15/06/2016,6,7,11,18
42,15/06/2016,7,24,40,64
42,15/06/2016,8,48,103,151
42,15/06/2016,9,22,68,90
42,15/06/2016,10,9,38,47
42,15/06/2016,11,16,24,40
42,15/06/2016,12,18,25,43
42,15/06/2016,13,18,22,40
42,15/06/2016,14,22,28,50
42,15/06/2016,15,33,18,51
42,15/06/2016,16,43,39,82
42,15/06/2016,17,86,66,152
42,15/06/2016,18,49,43,92
42,15/06/2016,19,25,21,46
42,15/06/2016,20,29,14,43
42,15/06/2016,21,17,15,32
42,15/06/2016,22,9,6,15
42,15/06/2016,23,4,5,9
42,16/06/2016,0,5,3,8
42,16/06/2016,1,2,1,3
42,16/06/2016,2,1,0,1
42,16/06/2016,3,1,0,1
42,16/06/2016,4,0,0,0
42,16/06/2016,5,2,1,3
42,16/06/2016,6,6,9,15
42,16/06/2016,7,18,31,49
42,16/06/2016,8,45,94,139
42,16/06/2016,9,27,66,93
42,16/06/2016,10,8,27,35
42,16/06/2016,11,8,21,29
42,16/06/2016,12,11,24,35
42,16/06/2016,13,15,24,39
42,16/06/2016,14,24,19,43
42,16/06/2016,15,16,21,37
42,16/06/2016,16,47,33,80
42,16/06/2016,17,63,71,134
42,16/06/2016,18,60,40,100
42,16/06/2016,19,42,26,68
42,16/06/2016,20,30,20,50
42,16/06/2016,21,23,15,38
42,16/06/2016,22,15,5,20
42,16/06/2016,23,9,9,18
42,17/06/2016,0,3,4,7
42,17/06/2016,1,2,0,2
42,17/06/2016,2,0,1,1
42,17/06/2016,3,0,1,1
42,17/06/2016,4,0,0,0
42,17/06/2016,5,2,1,3
42,17/06/2016,6,8,10,18
42,17/06/2016,7,15,36,51
42,17/06/2016,8,30,93,123
42,17/06/2016,9,31,53,84
42,17/06/2016,10,15,22,37
42,17/06/2016,11,11,24,35
42,17/06/2016,12,22,23,45
42,17/06/2016,13,13,15,28
42,17/06/2016,14,15,11,26
42,17/06/2016,15,25,17,42
42,17/06/2016,16,36,33,69
42,17/06/2016,17,48,37,85
42,17/06/2016,18,44,32,76
42,17/06/2016,19,25,14,39
42,17/06/2016,20,13,12,25
42,17/06/2016,21,9,8,17
42,17/06/2016,22,7,8,15
42,17/06/2016,23,7,7,14
42,18/06/2016,0,10,5,15
42,18/06/2016,1,3,1,4
42,18/06/2016,2,0,1,1
42,18/06/2016,3,1,1,2
42,18/06/2016,4,1,1,2
42,18/06/2016,5,1,3,4
42,18/06/2016,6,0,2,2
42,18/06/2016,7,7,9,16
42,18/06/2016,8,10,9,19
42,18/06/2016,9,20,24,44
42,18/06/2016,10,17,23,40
42,18/06/2016,11,22,43,65
42,18/06/2016,12,32,29,61
42,18/06/2016,13,34,52,86
42,18/06/2016,14,28,31,59
42,18/06/2016,15,22,30,52
42,18/06/2016,16,26,31,57
42,18/06/2016,17,30,42,72
42,18/06/2016,18,39,28,67
42,18/06/2016,19,28,19,47
42,18/06/2016,20,28,22,50
42,18/06/2016,21,20,12,32
42,18/06/2016,22,15,9,24
42,18/06/2016,23,8,7,15